Surface_Code,Court_Code,Series_Code,Round_Code,Best of,Rank_1,Rank_2,Rank_Diff
1,0,2,0,5,133,111,-22
3,0,6,0,3,90,42,-48
1,0,0,0,3,123,93,-30
1,0,1,0,3,105,77,-28
3,0,3,6,3,75,46,-29
1,0,6,3,3,16,4,-12
3,0,2,3,5,22,8,-14
3,0,5,1,3,64,3,-61
1,0,5,1,3,41,35,-6
2,0,0,0,3,25,123,98
3,1,1,1,3,20,43,23
1,0,0,4,3,31,44,13
3,0,6,1,3,21,62,41
1,0,3,0,3,97,100,3
3,1,6,0,3,20,31,11
3,0,5,0,3,85,39,-46
2,0,2,0,5,44,221,177
1,0,3,0,3,91,94,3
3,0,2,2,5,6,30,24
2,0,2,0,5,228,20,-208
3,1,0,7,3,10,50,40
3,0,2,0,5,96,79,-17
3,0,6,1,3,92,7,-85
1,0,4,0,3,158,28,-130
3,1,0,1,3,10,79,69
3,0,0,4,3,41,37,-4
1,0,0,1,3,84,37,-47
3,1,0,1,3,121,47,-74
1,0,0,0,3,918,80,-838
2,0,3,1,3,50,80,30
1,0,5,1,3,29,4,-25
3,0,6,0,3,40,42,2
3,0,2,0,5,7,34,27
3,1,5,1,3,44,13,-31
1,0,3,4,3,37,16,-21
3,0,1,0,3,56,82,26
3,0,3,4,3,88,23,-65
3,0,0,0,3,40,21,-19
3,0,1,4,3,39,7,-32
3,0,2,0,5,288,122,-166
1,0,0,4,3,34,57,23
3,0,6,4,3,17,23,6
2,0,2,0,5,146,82,-64
1,0,3,0,3,175,14,-161
3,1,1,7,3,46,24,-22
1,0,1,0,3,43,44,1
2,0,0,0,3,42,50,8
3,0,1,1,3,52,33,-19
3,0,1,1,3,27,5,-22
1,0,3,4,3,17,27,10
3,1,3,0,3,196,10,-186
2,0,2,1,5,80,101,21
1,0,6,4,3,36,7,-29
3,0,5,1,3,28,48,20
2,0,3,1,3,91,362,271
1,0,3,0,3,304,348,44
3,0,2,0,5,66,185,119
3,0,5,0,3,74,192,118
1,0,3,0,3,98,87,-11
3,1,0,0,3,73,145,72
3,1,0,1,3,40,61,21
3,0,6,1,3,18,154,136
3,0,4,2,3,300,140,-160
3,0,2,1,5,14,218,204
3,1,6,1,3,11,29,18
2,0,0,4,3,116,102,-14
3,0,2,1,5,47,8,-39
1,0,0,4,3,70,1,-69
3,1,3,6,3,99,10,-89
2,0,3,1,3,107,76,-31
1,0,4,0,3,235,59,-176
3,0,1,0,3,7,46,39
1,0,3,0,3,586,96,-490
3,1,0,6,3,33,47,14
3,0,4,1,3,68,108,40
2,0,2,1,5,33,95,62
1,0,6,2,3,52,9,-43
3,0,5,4,3,64,35,-29
1,0,0,1,3,104,50,-54
1,0,1,0,3,24,113,89
1,0,0,6,3,32,208,176
1,0,0,1,3,131,103,-28
3,0,0,0,3,190,40,-150
3,0,5,0,3,38,404,366
1,0,2,0,5,157,91,-66
3,0,1,0,3,42,5,-37
2,0,3,1,3,176,25,-151
1,0,5,4,3,31,20,-11
3,0,0,0,3,59,272,213
3,1,6,0,3,15,30,15
3,0,2,0,5,14,70,56
2,0,2,6,5,125,11,-114
3,0,6,2,3,7,16,9
1,0,6,1,3,113,21,-92
2,0,0,0,3,34,180,146
3,0,6,0,3,19,47,28
2,0,2,0,5,67,121,54
3,0,0,0,3,145,112,-33
1,0,0,0,3,78,67,-11
0,1,3,0,3,46,27,-19
2,0,0,0,3,218,335,117
3,0,1,2,3,86,53,-33
3,1,4,1,3,58,4,-54
1,0,2,3,5,23,125,102
2,0,2,0,5,174,105,-69
3,0,5,0,3,37,33,-4
1,0,4,0,3,50,80,30
1,0,0,1,3,15,96,81
1,0,2,0,5,5,58,53
1,0,0,6,3,24,134,110
1,0,3,1,3,52,240,188
2,0,3,0,3,67,128,61
3,0,6,0,3,14,101,87
2,0,3,1,3,104,7,-97
3,1,0,0,3,126,101,-25
3,1,6,0,3,43,10,-33
2,0,3,0,3,64,12,-52
1,0,5,1,3,17,49,32
1,0,4,2,3,71,31,-40
3,1,0,1,3,68,92,24
1,0,0,0,3,26,95,69
1,0,3,0,3,54,59,5
1,0,4,1,3,4,335,331
1,0,2,0,5,43,28,-15
3,0,2,2,5,24,4,-20
2,0,2,1,5,67,58,-9
3,0,2,3,5,15,4,-11
1,0,0,4,3,33,193,160
3,1,6,0,3,66,26,-40
3,0,6,1,3,35,42,7
3,0,0,0,3,75,94,19
3,1,7,5,3,2,3,1
1,0,4,0,3,113,115,2
3,0,6,1,3,38,7,-31
3,0,6,0,3,45,38,-7
3,0,4,0,3,141,92,-49
2,0,2,1,5,172,68,-104
1,0,0,6,3,171,18,-153
1,0,2,0,5,44,84,40
1,0,2,0,5,1015,19,-996
1,0,0,1,3,140,315,175
3,0,0,4,3,88,90,2
2,0,3,1,3,197,147,-50
3,0,6,2,3,58,37,-21
2,0,3,0,3,31,73,42
3,0,4,1,3,19,130,111
1,0,3,0,3,43,90,47
3,1,0,0,3,127,116,-11
3,0,3,0,3,141,117,-24
1,0,0,1,3,56,39,-17
2,0,2,0,5,97,95,-2
3,1,0,0,3,50,204,154
3,0,0,2,3,63,107,44
3,0,3,1,3,194,36,-158
1,0,3,0,3,189,10,-179
2,0,0,0,3,43,72,29
3,0,5,2,3,46,6,-40
1,0,2,0,5,112,55,-57
3,0,2,2,5,16,21,5
1,0,2,0,5,131,4,-127
1,0,0,0,3,45,384,339
3,0,0,2,3,52,63,11
3,0,2,0,5,32,119,87
3,1,7,5,3,9,2,-7
3,1,0,0,3,25,192,167
2,0,1,1,3,36,2,-34
3,0,6,3,3,19,39,20
1,0,6,0,3,58,34,-24
2,0,0,0,3,57,254,197
3,0,2,1,5,284,28,-256
1,0,3,0,3,138,71,-67
2,0,3,6,3,98,27,-71
3,0,0,1,3,52,79,27
2,0,1,0,3,20,92,72
1,0,5,2,3,53,1,-52
1,0,0,0,3,117,98,-19
3,0,6,1,3,25,16,-9
3,1,0,0,3,107,83,-24
3,1,1,6,3,7,9,2
1,0,0,1,3,13,159,146
1,0,1,1,3,71,26,-45
1,0,4,0,3,41,20,-21
1,0,3,0,3,126,319,193
2,0,0,0,3,402,86,-316
3,1,0,0,3,122,367,245
1,0,2,2,5,25,16,-9
3,1,5,1,3,42,2,-40
1,0,2,1,5,52,106,54
1,0,2,0,5,56,101,45
3,0,2,0,5,20,73,53
2,0,2,0,5,4,79,75
1,1,0,4,3,27,64,37
1,0,5,0,3,74,47,-27
3,0,0,1,3,22,79,57
1,0,3,7,3,7,72,65
3,1,0,4,3,31,14,-17
1,0,6,0,3,39,57,18
1,0,5,0,3,42,83,41
1,0,0,0,3,108,28,-80
3,0,6,0,3,46,48,2
2,0,2,0,5,114,97,-17
1,0,0,0,3,150,79,-71
0,1,3,4,3,95,38,-57
1,0,6,4,3,1,6,5
3,1,1,0,3,24,5,-19
3,0,4,1,3,34,4,-30
1,0,3,7,3,42,66,24
1,0,1,0,3,93,103,10
3,1,0,0,3,62,40,-22
0,1,3,1,3,21,69,48
3,1,4,1,3,39,70,31
1,0,0,4,3,150,96,-54
1,0,3,1,3,53,303,250
2,0,2,0,5,83,51,-32
1,0,3,4,3,33,77,44
3,1,0,1,3,26,51,25
3,0,1,6,3,53,80,27
1,0,1,0,3,47,29,-18
1,0,5,7,5,31,16,-15
3,0,2,0,5,23,113,90
1,0,0,1,3,255,285,30
1,0,0,0,3,37,157,120
1,0,5,0,3,10,24,14
1,0,3,0,3,232,68,-164
3,0,3,0,3,181,58,-123
3,0,4,1,3,126,22,-104
3,0,6,2,3,42,51,9
1,0,5,2,3,16,4,-12
3,1,5,0,3,48,31,-17
3,0,4,7,3,14,1,-13
3,1,0,0,3,66,49,-17
1,0,6,0,3,38,150,112
1,0,3,0,3,20,112,92
2,0,3,0,3,54,285,231
1,0,0,4,3,134,138,4
1,0,3,1,3,13,85,72
3,0,0,1,3,96,3,-93
3,0,2,2,5,10,120,110
3,0,0,1,3,42,196,154
1,0,0,1,3,51,319,268
3,0,6,0,3,66,105,39
1,0,5,0,3,37,12,-25
2,0,3,2,3,5,35,30
3,0,4,2,3,83,32,-51
3,1,1,1,3,28,11,-17
3,0,0,0,3,64,62,-2
3,0,0,0,3,61,100,39
1,0,4,1,3,43,63,20
1,0,2,0,5,24,84,60
3,0,2,0,5,64,91,27
1,0,0,0,3,37,148,111
2,0,2,1,5,55,75,20
2,0,2,2,5,53,18,-35
3,0,3,0,3,1,49,48
3,1,0,4,3,25,66,41
1,0,6,0,3,32,59,27
3,0,0,0,3,70,75,5
3,1,3,1,3,88,60,-28
1,0,6,1,3,33,4,-29
3,1,6,2,3,75,1,-74
1,0,0,0,3,142,453,311
1,0,1,0,3,117,78,-39
3,1,4,0,3,28,102,74
3,1,0,1,3,59,38,-21
3,0,3,4,3,80,179,99
3,1,0,0,3,105,89,-16
3,0,3,1,3,154,60,-94
3,1,6,0,3,72,36,-36
3,0,6,0,3,107,13,-94
2,0,3,1,3,47,28,-19
3,0,6,2,3,15,9,-6
3,1,6,2,3,1,28,27
1,1,0,4,3,22,73,51
3,0,3,6,3,90,27,-63
3,1,6,0,3,25,23,-2
3,0,0,4,3,2,56,54
2,0,1,0,3,66,5,-61
3,0,0,0,3,81,86,5
3,0,3,0,3,150,621,471
3,0,6,2,3,18,9,-9
1,0,3,0,3,52,78,26
3,1,0,0,3,52,167,115
3,1,0,0,3,97,58,-39
1,0,5,0,3,36,15,-21
3,0,0,1,3,62,55,-7
3,0,2,1,5,6,38,32
3,0,2,1,5,40,8,-32
3,0,5,1,3,31,6,-25
3,0,6,0,3,58,48,-10
2,0,0,0,3,104,54,-50
3,0,6,1,3,3,50,47
1,0,0,1,3,21,104,83
3,0,0,7,3,91,64,-27
3,1,1,0,3,86,140,54
3,0,6,4,3,21,8,-13
1,0,0,1,3,54,44,-10
1,0,0,6,3,48,6,-42
1,0,2,1,5,130,19,-111
3,0,2,0,5,110,98,-12
2,0,2,0,5,204,27,-177
3,0,2,3,5,31,12,-19
3,1,0,0,3,213,97,-116
2,0,0,0,3,111,18,-93
1,0,4,0,3,224,93,-131
1,0,2,0,5,92,73,-19
3,0,0,1,3,129,51,-78
1,0,5,0,3,8,148,140
3,0,2,1,5,27,127,100
3,0,2,1,5,81,24,-57
3,0,2,0,5,114,101,-13
1,0,0,0,3,68,69,1
1,0,0,0,3,85,462,377
3,0,0,1,3,206,19,-187
3,1,1,1,3,123,8,-115
3,1,3,1,3,23,44,21
2,0,2,0,5,111,8,-103
3,0,2,1,5,23,50,27
2,0,2,0,5,80,2,-78
3,0,2,0,5,52,26,-26
2,0,0,1,3,80,70,-10
3,0,2,0,5,61,55,-6
3,0,2,0,5,129,16,-113
2,0,2,2,3,10,24,14
1,0,0,1,3,15,65,50
1,0,0,0,3,223,77,-146
2,0,2,0,5,40,119,79
1,0,3,0,3,147,70,-77
1,0,0,6,3,19,8,-11
1,0,6,2,3,25,12,-13
1,0,2,0,5,82,104,22
3,0,6,1,3,87,2,-85
1,0,0,1,3,83,24,-59
3,0,5,1,3,33,34,1
1,0,6,4,3,7,4,-3
1,0,6,0,3,15,136,121
3,0,7,5,3,7,4,-3
1,0,3,4,3,31,128,97
1,0,0,0,3,151,158,7
3,0,0,0,3,126,85,-41
3,0,6,4,3,9,4,-5
3,0,0,6,3,162,1,-161
1,0,2,1,5,199,100,-99
3,0,2,4,5,78,3,-75
3,0,6,0,3,38,21,-17
3,0,3,1,3,167,50,-117
3,0,0,0,3,13,87,74
3,0,1,0,3,39,10,-29
2,0,2,1,5,48,29,-19
1,0,3,0,3,139,352,213
3,0,5,0,3,47,55,8
1,0,3,0,3,89,123,34
2,0,3,2,3,2,74,72
3,0,0,4,3,116,15,-101
3,0,0,1,3,91,148,57
3,0,6,2,3,14,57,43
1,0,2,0,5,96,16,-80
3,1,0,1,3,109,21,-88
3,0,2,0,5,307,77,-230
1,0,3,4,3,45,17,-28
3,1,0,0,3,57,450,393
1,0,6,2,3,15,57,42
2,0,0,1,3,42,36,-6
3,0,2,0,5,55,13,-42
2,0,2,0,5,27,186,159
1,0,4,6,3,88,32,-56
0,1,5,0,3,53,36,-17
2,0,0,0,3,4,60,56
1,0,3,0,3,57,214,157
3,0,3,1,3,60,7,-53
3,0,1,0,3,89,72,-17
3,0,2,1,5,49,52,3
3,0,0,4,3,129,20,-109
1,0,6,1,3,39,3,-36
3,0,3,0,3,74,85,11
2,0,3,0,3,103,99,-4
3,1,3,4,3,20,12,-8
3,0,0,0,3,904,47,-857
3,0,4,2,3,503,64,-439
1,0,1,6,3,54,82,28
3,1,0,4,3,228,36,-192
3,0,3,0,3,963,74,-889
1,0,3,6,3,117,98,-19
2,0,2,1,5,19,63,44
2,0,2,1,5,308,181,-127
1,0,3,1,3,107,66,-41
1,0,1,0,3,46,323,277
3,0,5,0,3,75,50,-25
3,1,4,1,3,31,7,-24
3,0,2,4,5,21,32,11
3,0,6,6,3,41,6,-35
3,1,0,4,3,25,11,-14
3,0,2,1,5,104,38,-66
3,1,0,1,3,280,52,-228
3,0,2,1,5,31,46,15
1,0,0,0,3,43,74,31
1,0,4,0,3,104,88,-16
3,1,0,1,3,28,54,26
3,0,2,0,5,5,66,61
3,0,6,1,3,83,9,-74
0,1,3,4,3,71,31,-40
2,0,1,0,3,36,191,155
3,0,3,0,3,193,55,-138
1,0,3,4,3,118,6,-112
1,0,3,0,3,4,147,143
3,1,6,0,3,48,36,-12
3,1,0,1,3,181,124,-57
1,0,3,4,3,53,15,-38
3,0,3,1,3,80,524,444
2,0,1,0,3,17,137,120
3,1,0,0,3,92,388,296
1,0,3,0,3,60,4,-56
3,1,0,0,3,63,98,35
3,0,0,4,3,36,20,-16
2,0,2,1,5,111,45,-66
3,0,3,2,3,30,205,175
2,0,0,6,3,82,30,-52
3,0,2,1,5,255,138,-117
3,0,6,0,3,38,154,116
1,0,2,1,5,42,48,6
2,0,2,1,5,67,65,-2
3,1,7,7,3,2,3,1
0,1,3,0,3,45,124,79
1,0,0,1,3,73,49,-24
3,1,4,6,3,13,11,-2
1,0,1,4,3,6,8,2
0,1,3,0,3,45,12,-33
3,1,0,0,3,28,20,-8
3,0,3,0,3,58,30,-28
1,0,0,4,3,75,15,-60
3,1,0,0,3,49,98,49
3,0,4,0,3,83,50,-33
3,0,2,0,5,6,62,56
1,0,0,0,3,195,37,-158
3,0,3,0,3,79,92,13
3,1,0,0,3,255,32,-223
1,0,3,1,3,86,52,-34
0,1,5,4,3,37,13,-24
1,0,4,4,3,59,111,52
1,0,3,0,3,-1,137,138
3,0,2,2,5,50,4,-46
2,0,3,4,3,158,32,-126
1,0,2,0,5,80,117,37
3,1,0,0,3,100,43,-57
1,0,0,7,3,9,36,27
3,1,4,0,3,46,11,-35
3,0,6,0,3,136,97,-39
1,0,3,1,3,316,111,-205
3,0,0,0,3,313,36,-277
3,0,2,2,5,8,63,55
3,1,0,0,3,65,126,61
3,0,6,0,3,35,60,25
3,0,6,0,3,58,52,-6
3,1,0,6,3,9,89,80
3,0,6,2,3,7,30,23
3,0,6,0,3,224,35,-189
1,0,3,1,3,21,62,41
1,0,0,4,3,64,52,-12
3,1,7,5,3,7,6,-1
1,0,2,1,5,134,4,-130
3,0,5,0,3,81,44,-37
3,0,2,1,5,66,20,-46
3,0,0,0,3,66,68,2
3,0,6,0,3,77,42,-35
1,0,6,0,3,27,63,36
3,0,1,1,3,3,64,61
3,0,2,1,5,59,44,-15
1,0,2,7,5,3,4,1
1,0,6,1,3,315,38,-277
1,0,5,0,3,29,38,9
0,1,3,4,3,49,153,104
2,0,0,4,3,67,335,268
3,0,0,1,3,33,81,48
3,0,4,0,3,89,17,-72
1,0,2,0,5,96,134,38
3,1,0,0,3,441,109,-332
3,0,0,1,3,39,17,-22
3,0,2,3,5,55,32,-23
3,0,1,1,3,13,34,21
1,0,1,1,3,7,83,76
2,0,2,2,5,1,41,40
1,0,0,7,3,126,82,-44
2,0,3,1,3,52,61,9
3,1,1,0,3,24,73,49
3,1,0,1,3,144,69,-75
1,0,0,1,3,69,133,64
1,0,2,0,5,30,95,65
3,0,1,0,3,4,255,251
3,1,3,0,3,89,123,34
1,0,3,4,3,69,133,64
3,0,0,0,3,171,120,-51
3,0,2,1,5,7,51,44
3,0,3,0,3,203,170,-33
1,0,0,6,3,35,15,-20
3,0,6,1,3,18,141,123
3,0,2,2,5,7,42,35
3,1,3,4,3,143,21,-122
3,0,3,0,3,111,89,-22
3,0,4,0,3,73,60,-13
1,0,4,0,3,268,201,-67
3,0,0,4,3,3,35,32
1,0,3,0,3,95,80,-15
1,0,3,0,3,312,34,-278
3,1,0,6,3,45,47,2
3,0,5,4,3,8,34,26
1,0,6,0,3,16,171,155
3,0,6,1,3,11,44,33
1,0,2,1,5,67,8,-59
3,0,3,0,3,57,72,15
3,0,2,0,5,27,58,31
3,0,0,1,3,46,66,20
3,0,3,6,3,104,25,-79
1,0,1,1,3,55,3,-52
1,0,3,0,3,98,3,-95
0,1,3,0,3,127,54,-73
2,0,3,7,3,40,1,-39
3,1,0,1,3,61,104,43
3,0,0,6,3,52,133,81
3,0,1,4,3,42,72,30
1,0,3,0,3,433,851,418
1,0,3,0,3,152,147,-5
3,1,0,0,3,974,1890,916
1,0,0,4,3,38,19,-19
1,0,4,1,3,57,50,-7
1,1,0,4,3,22,171,149
3,0,0,0,3,34,76,42
3,0,0,0,3,92,45,-47
3,0,5,0,3,72,61,-11
3,0,6,0,3,111,104,-7
1,0,3,0,3,68,368,300
3,1,3,6,3,77,20,-57
1,0,2,0,5,15,99,84
3,1,0,0,3,164,64,-100
3,0,1,0,3,99,25,-74
3,0,5,0,3,99,52,-47
2,0,1,0,3,146,42,-104
3,0,2,1,5,4,41,37
2,0,0,0,3,148,116,-32
1,0,2,0,5,73,19,-54
3,1,0,0,3,120,65,-55
1,0,3,1,3,115,76,-39
2,0,3,1,3,166,78,-88
2,0,2,0,5,60,25,-35
1,0,2,0,5,60,135,75
1,0,0,4,3,63,15,-48
3,0,5,1,3,28,52,24
1,0,3,4,3,233,94,-139
3,0,2,0,5,27,33,6
3,0,0,0,3,39,173,134
3,1,0,1,3,59,86,27
3,1,0,4,3,11,61,50
3,0,6,7,3,1,3,2
3,0,0,1,3,59,27,-32
1,0,3,0,3,107,121,14
3,0,3,4,3,200,11,-189
3,0,2,0,5,5,93,88
1,0,3,1,3,184,68,-116
1,0,5,6,3,1,55,54
3,1,5,1,3,33,17,-16
1,0,1,2,3,7,72,65
1,0,2,2,5,15,20,5
3,0,1,4,3,63,42,-21
3,0,2,1,5,8,97,89
3,0,0,1,3,90,43,-47
3,0,6,0,3,40,16,-24
2,0,2,0,5,8,40,32
3,0,6,1,3,6,44,38
3,1,0,1,3,63,18,-45
3,1,6,2,3,5,25,20
3,0,1,1,3,11,139,128
3,0,0,6,3,86,9,-77
2,0,0,6,3,3,7,4
2,0,3,0,3,514,172,-342
1,0,3,6,3,53,8,-45
1,0,5,1,3,42,9,-33
3,0,0,0,3,79,88,9
1,0,5,2,3,7,40,33
3,0,2,2,5,47,27,-20
3,1,0,0,3,48,87,39
3,0,1,1,3,17,71,54
3,0,6,6,3,4,1,-3
1,0,6,2,3,29,17,-12
1,0,6,0,3,46,59,13
1,0,5,0,3,50,40,-10
0,1,3,0,3,93,145,52
3,1,0,6,3,107,39,-68
2,0,3,7,3,7,13,6
1,0,3,4,3,90,58,-32
3,0,2,0,5,96,6,-90
3,1,5,1,3,60,13,-47
1,0,3,0,3,72,948,876
2,0,1,4,3,42,38,-4
1,0,3,0,3,3,617,614
3,0,2,0,5,68,3,-65
3,1,1,0,3,27,56,29
3,0,1,0,3,165,176,11
3,0,0,1,3,281,12,-269
1,0,0,0,3,316,66,-250
1,0,3,0,3,6,74,68
1,0,0,0,3,226,125,-101
3,0,2,0,5,71,162,91
1,0,2,6,5,7,17,10
0,1,3,1,3,75,1,-74
1,0,5,0,3,25,7,-18
1,0,0,0,3,54,67,13
3,0,0,1,3,79,17,-62
1,0,3,0,3,11,94,83
3,1,1,0,3,23,31,8
3,0,6,2,3,87,27,-60
1,0,0,6,3,30,45,15
3,0,3,1,3,89,26,-63
3,1,3,0,3,104,166,62
1,0,3,4,3,113,20,-93
3,1,4,1,3,213,11,-202
3,0,0,0,3,60,56,-4
2,0,0,4,3,8,82,74
2,0,0,0,3,67,15,-52
3,0,5,0,3,4,33,29
3,0,0,0,3,135,101,-34
1,0,2,0,5,202,69,-133
1,0,3,7,3,47,13,-34
1,0,0,0,3,70,32,-38
3,0,1,0,3,64,157,93
3,0,4,2,3,50,69,19
3,0,3,6,3,31,8,-23
3,1,1,0,3,212,15,-197
1,0,0,0,3,84,47,-37
1,0,0,4,3,26,79,53
2,0,2,1,5,3,69,66
1,0,2,0,5,98,2,-96
3,1,0,0,3,62,65,3
1,0,6,1,3,8,40,32
3,0,6,1,3,19,7,-12
1,0,6,6,3,1,45,44
1,0,3,0,3,118,97,-21
3,0,6,1,3,42,25,-17
3,0,5,2,3,128,21,-107
3,0,1,0,3,87,267,180
3,0,0,1,3,30,63,33
3,1,1,4,3,49,16,-33
2,0,3,4,3,41,23,-18
3,1,0,0,3,60,119,59
3,1,1,1,3,62,298,236
3,0,2,2,5,79,24,-55
1,0,0,0,3,76,94,18
1,0,3,0,3,138,135,-3
1,0,2,1,5,57,25,-32
3,0,2,0,5,72,132,60
3,0,2,0,5,44,47,3
3,1,0,7,3,23,102,79
3,0,2,0,5,61,46,-15
1,0,0,0,3,605,41,-564
1,0,2,2,5,2,41,39
2,0,2,2,5,25,122,97
1,0,5,2,3,7,11,4
1,0,1,1,3,86,40,-46
3,1,4,1,3,278,49,-229
3,1,0,6,3,9,44,35
3,0,0,0,3,92,53,-39
3,0,0,4,3,130,170,40
3,1,3,6,3,35,24,-11
2,0,0,1,3,118,59,-59
1,0,5,0,3,53,21,-32
1,0,6,1,3,9,78,69
2,0,3,0,3,11,557,546
3,1,0,1,3,55,34,-21
1,0,0,0,3,134,116,-18
1,0,3,1,3,371,101,-270
3,0,2,3,5,119,4,-115
3,0,5,0,3,38,22,-16
3,0,3,1,3,13,31,18
3,0,6,2,3,10,62,52
1,0,2,1,5,102,7,-95
3,1,0,1,3,19,55,36
1,0,0,1,3,72,16,-56
3,1,0,0,3,57,38,-19
1,0,3,4,3,52,104,52
3,0,2,1,5,8,73,65
1,0,5,0,3,82,5,-77
3,1,0,1,3,36,302,266
1,0,3,0,3,117,236,119
3,0,5,1,3,19,31,12
3,0,6,0,3,52,30,-22
3,0,0,0,3,505,125,-380
1,0,0,6,3,69,65,-4
2,0,0,4,3,72,142,70
3,1,4,1,3,92,102,10
3,0,1,0,3,10,123,113
1,0,0,0,3,1064,85,-979
1,0,2,0,5,133,65,-68
3,1,1,1,3,12,76,64
1,0,0,1,3,104,97,-7
3,0,2,2,5,14,27,13
3,0,5,0,3,69,23,-46
3,0,5,2,3,10,58,48
1,0,3,0,3,72,316,244
3,0,1,1,3,8,81,73
1,0,2,0,5,43,96,53
3,0,0,0,3,95,56,-39
2,0,1,4,3,13,39,26
3,1,3,0,3,33,51,18
1,0,0,1,3,83,63,-20
1,0,0,1,3,455,48,-407
3,0,5,0,3,64,76,12
3,0,2,2,5,24,48,24
3,0,0,1,3,41,18,-23
3,1,6,0,3,38,77,39
3,1,0,0,3,102,52,-50
1,0,0,0,3,74,87,13
3,0,5,6,3,4,2,-2
3,0,4,0,3,15,30,15
3,0,2,1,5,87,75,-12
3,1,7,5,3,3,2,-1
3,0,6,2,3,98,18,-80
2,0,0,0,3,129,137,8
3,1,0,1,3,110,50,-60
3,0,3,0,3,129,100,-29
3,1,0,1,3,35,113,78
2,0,0,0,3,51,59,8
1,0,1,1,3,38,46,8
0,1,3,6,3,33,17,-16
1,0,3,0,3,89,193,104
1,0,5,0,3,32,45,13
3,0,0,2,3,45,12,-33
3,0,2,1,5,50,79,29
1,0,6,6,3,40,3,-37
3,0,6,1,3,23,58,35
2,0,1,6,3,3,43,40
3,1,3,1,3,76,89,13
1,0,3,0,3,94,7,-87
3,1,0,0,3,71,40,-31
3,0,3,1,3,224,58,-166
2,0,0,1,3,35,62,27
2,0,2,0,5,41,76,35
3,0,2,1,5,38,67,29
3,0,0,0,3,14,42,28
1,0,6,2,3,1,20,19
3,0,3,0,3,263,63,-200
2,0,0,1,3,21,201,180
1,0,0,1,3,57,70,13
3,0,4,1,3,286,35,-251
3,0,0,0,3,120,212,92
3,1,3,0,3,84,122,38
3,0,0,0,3,2,63,61
3,1,6,2,3,4,13,9
1,0,3,1,3,56,88,32
2,0,2,0,5,70,23,-47
2,0,1,6,3,2,32,30
3,1,0,0,3,33,105,72
1,0,3,0,3,197,34,-163
2,0,0,0,3,45,43,-2
1,0,3,1,3,61,105,44
3,0,1,7,3,117,25,-92
3,0,0,1,3,50,68,18
3,1,0,1,3,61,45,-16
3,0,5,0,3,56,2,-54
3,0,5,0,3,5,19,14
3,0,5,2,3,13,64,51
3,0,6,1,3,29,65,36
3,0,3,0,3,103,199,96
3,1,1,4,3,18,17,-1
1,0,1,4,3,32,26,-6
3,0,1,4,3,10,23,13
1,0,4,1,3,61,176,115
3,0,3,0,3,7,56,49
2,0,1,0,3,35,16,-19
3,0,1,0,3,8,469,461
3,0,4,1,3,102,11,-91
3,0,3,0,3,97,5,-92
1,0,6,4,3,5,4,-1
2,0,2,1,5,35,29,-6
1,0,0,4,3,40,16,-24
3,0,5,2,3,23,13,-10
1,0,6,2,3,95,6,-89
3,0,5,1,3,85,35,-50
1,0,3,0,3,86,185,99
3,0,3,1,3,68,82,14
1,0,3,1,3,44,55,11
3,1,0,4,3,46,37,-9
0,1,3,0,3,84,97,13
3,0,2,1,5,48,2,-46
1,0,0,0,3,84,54,-30
3,0,6,0,3,176,58,-118
1,0,0,0,3,39,96,57
2,0,0,0,3,75,66,-9
1,0,5,0,3,37,74,37
3,0,5,1,3,11,120,109
2,0,3,0,3,38,62,24
3,1,3,4,3,20,44,24
1,0,1,1,3,10,150,140
3,0,1,6,3,5,9,4
3,0,6,3,3,21,32,11
1,0,3,4,3,7,66,59
3,1,0,4,3,47,69,22
1,0,0,4,3,46,69,23
1,0,3,0,3,95,99,4
1,0,6,6,3,2,3,1
2,0,2,0,5,56,261,205
1,0,0,1,3,107,62,-45
3,1,6,0,3,36,44,8
3,0,3,1,3,244,120,-124
3,1,0,6,3,20,28,8
1,0,2,0,5,47,51,4
1,0,2,0,5,93,49,-44
0,1,3,1,3,36,28,-8
1,0,6,0,3,91,78,-13
3,1,1,1,3,66,4,-62
1,0,6,1,3,13,151,138
3,0,0,0,3,66,52,-14
1,0,5,1,3,2,154,152
1,0,5,0,3,26,7,-19
3,0,6,1,3,12,39,27
3,0,3,0,3,60,246,186
3,0,2,4,5,11,5,-6
3,1,6,0,3,35,39,4
3,0,6,3,3,57,4,-53
3,0,6,1,3,22,14,-8
1,0,0,6,3,21,30,9
3,1,3,1,3,194,61,-133
3,0,6,1,3,10,33,23
1,0,5,0,3,107,50,-57
3,1,6,0,3,55,20,-35
1,0,3,6,3,20,15,-5
1,0,6,1,3,47,34,-13
3,0,2,0,5,173,53,-120
1,0,5,7,5,53,2,-51
3,0,0,0,3,77,149,72
1,0,1,0,3,35,93,58
3,1,0,7,3,11,7,-4
2,0,2,2,5,21,66,45
3,1,0,0,3,56,87,31
3,0,3,0,3,61,763,702
3,1,4,0,3,43,61,18
3,0,4,6,3,34,10,-24
1,0,2,0,5,57,109,52
3,0,6,0,3,146,84,-62
2,0,2,1,5,49,19,-30
3,1,0,0,3,151,69,-82
2,0,0,1,3,96,113,17
1,0,2,3,5,9,7,-2
2,0,0,0,3,96,91,-5
1,0,3,1,3,59,64,5
3,0,6,1,3,16,69,53
1,0,6,1,3,40,56,16
3,0,5,0,3,32,35,3
1,0,6,1,3,68,10,-58
3,0,2,0,5,44,20,-24
3,0,0,1,3,50,83,33
2,0,3,0,3,48,93,45
3,0,2,3,5,12,7,-5
3,0,2,2,5,89,144,55
3,0,5,4,3,24,61,37
3,1,0,0,3,83,73,-10
3,0,6,1,3,8,47,39
1,0,2,4,5,27,3,-24
2,0,0,2,3,93,18,-75
1,0,3,0,3,95,135,40
3,1,1,0,3,107,7,-100
3,0,3,0,3,50,77,27
3,1,6,2,3,14,9,-5
2,0,1,0,3,94,147,53
2,0,0,6,3,17,26,9
1,0,5,1,3,99,37,-62
3,0,3,0,3,2,96,94
3,0,1,0,3,32,14,-18
3,0,0,0,3,53,74,21
3,0,1,0,3,11,32,21
3,1,3,1,3,285,21,-264
3,0,2,4,5,16,15,-1
2,0,2,0,5,81,124,43
3,0,0,0,3,133,261,128
1,0,6,0,3,52,42,-10
3,0,6,2,3,1,30,29
3,0,2,2,5,11,22,11
3,0,6,0,3,48,251,203
3,0,2,0,5,321,12,-309
3,0,2,0,5,100,31,-69
1,0,2,0,5,98,21,-77
3,0,2,4,5,89,35,-54
3,0,2,1,5,23,90,67
1,0,2,3,5,20,1,-19
3,0,0,0,3,104,19,-85
1,0,6,1,3,25,45,20
3,0,6,3,3,2,46,44
3,0,2,1,5,137,17,-120
3,0,0,0,3,73,80,7
1,0,2,1,5,14,91,77
2,0,2,2,5,82,103,21
1,0,5,1,3,22,55,33
3,0,4,7,3,7,32,25
3,0,0,4,3,14,71,57
3,0,2,0,5,60,73,13
1,0,3,1,3,122,75,-47
2,0,3,0,3,160,85,-75
1,0,6,1,3,34,13,-21
1,0,3,0,3,179,56,-123
1,1,0,0,3,159,73,-86
3,0,1,4,3,36,4,-32
1,0,0,0,3,96,182,86
3,1,0,1,3,62,93,31
1,1,0,1,3,98,24,-74
0,1,3,0,3,57,140,83
1,0,0,0,3,90,114,24
2,0,0,0,3,334,63,-271
3,1,3,0,3,121,124,3
1,0,3,1,3,119,53,-66
3,1,0,1,3,16,52,36
2,0,2,1,5,7,37,30
1,0,0,1,3,66,136,70
3,0,0,1,3,148,168,20
1,0,2,1,5,15,90,75
3,0,2,3,5,31,11,-20
2,0,3,0,3,31,54,23
1,0,0,1,3,8,67,59
1,0,0,0,3,1285,87,-1198
3,0,2,0,5,48,31,-17
1,0,6,0,3,69,62,-7
1,0,4,0,3,152,99,-53
0,1,3,0,3,104,312,208
3,0,3,5,3,40,84,44
1,0,3,1,3,39,34,-5
1,0,3,0,3,77,136,59
3,1,1,0,3,24,114,90
1,0,3,0,3,69,415,346
2,0,0,0,3,82,172,90
3,0,1,1,3,6,64,58
3,0,0,1,3,34,60,26
1,0,6,7,3,1,15,14
1,0,6,0,3,15,99,84
3,1,0,1,3,18,108,90
3,0,0,0,3,65,42,-23
1,0,0,0,3,133,28,-105
3,0,2,1,5,15,47,32
2,0,0,0,3,40,54,14
3,0,6,2,3,48,14,-34
3,0,5,0,3,62,47,-15
3,0,5,1,3,28,129,101
3,0,5,6,3,11,64,53
0,1,5,1,3,15,22,7
2,0,3,0,3,71,10,-61
1,0,5,0,3,75,61,-14
1,0,6,0,3,167,34,-133
2,0,2,1,5,26,214,188
3,0,1,1,3,12,68,56
3,0,0,0,3,84,64,-20
2,0,3,1,3,60,65,5
3,1,0,0,3,51,49,-2
1,0,5,2,3,57,100,43
1,0,2,3,5,145,20,-125
3,1,3,1,3,56,63,7
3,0,5,0,3,39,26,-13
3,1,0,0,3,32,93,61
1,0,3,5,3,30,113,83
3,0,3,1,3,114,155,41
3,0,6,0,3,42,75,33
3,0,6,0,3,81,70,-11
1,0,1,4,3,6,29,23
3,0,5,0,3,84,309,225
1,0,1,1,3,34,824,790
1,0,3,0,3,122,243,121
1,0,1,1,3,63,23,-40
1,0,6,2,3,21,53,32
3,1,6,0,3,22,50,28
1,0,0,0,3,348,115,-233
1,0,4,0,3,51,162,111
2,0,1,4,3,17,56,39
1,0,0,0,3,59,107,48
3,0,0,1,3,39,266,227
3,0,3,0,3,168,252,84
3,1,7,6,3,5,4,-1
2,0,0,0,3,80,51,-29
1,0,1,1,3,26,56,30
1,0,1,2,3,16,23,7
3,0,6,0,3,64,41,-23
3,0,0,1,3,27,37,10
3,0,0,1,3,40,39,-1
3,0,0,0,3,76,57,-19
3,0,6,2,3,33,9,-24
2,0,2,2,5,44,13,-31
1,0,2,2,5,33,4,-29
1,0,2,1,5,4,54,50
3,0,4,1,3,109,35,-74
1,0,0,0,3,106,52,-54
3,0,3,1,3,30,101,71
3,0,1,6,3,61,20,-41
3,0,3,4,3,18,21,3
1,0,2,0,5,12,93,81
1,0,2,6,5,4,1,-3
3,0,6,1,3,23,57,34
3,0,2,2,5,26,1,-25
3,0,6,2,3,8,14,6
3,0,3,1,3,372,78,-294
2,0,0,7,3,83,15,-68
1,0,3,0,3,463,54,-409
3,0,6,0,3,63,100,37
3,0,2,0,5,32,97,65
1,0,2,0,5,12,71,59
1,0,3,4,3,263,54,-209
1,0,4,2,3,155,86,-69
3,0,6,0,3,16,38,22
1,0,2,0,5,558,121,-437
3,0,1,1,3,17,59,42
1,0,0,0,3,162,133,-29
1,0,6,0,3,120,65,-55
3,0,3,1,3,50,121,71
3,1,3,0,3,25,64,39
3,0,2,1,5,121,1,-120
3,0,2,4,5,18,4,-14
3,0,1,0,3,133,283,150
3,1,3,0,3,17,247,230
3,0,0,7,3,58,69,11
3,0,2,0,5,24,103,79
1,0,3,0,3,16,92,76
3,0,2,0,5,43,9,-34
3,0,6,0,3,52,13,-39
3,0,2,0,5,12,179,167
2,0,0,1,3,77,41,-36
1,0,6,0,3,131,25,-106
3,0,6,4,3,16,10,-6
1,0,2,1,5,12,89,77
3,0,2,0,5,7,920,913
0,1,3,0,3,140,10,-130
3,1,3,0,3,60,66,6
1,0,3,0,3,68,92,24
3,0,5,3,3,44,13,-31
3,0,2,1,5,120,43,-77
3,0,3,1,3,65,36,-29
3,0,5,0,3,94,69,-25
1,0,0,4,3,44,36,-8
3,0,6,1,3,61,7,-54
3,0,1,0,3,57,118,61
1,0,2,0,5,90,8,-82
1,0,1,1,3,65,49,-16
1,0,1,2,3,1,54,53
1,0,6,0,3,62,85,23
1,0,0,1,3,63,54,-9
3,0,3,0,3,310,143,-167
1,0,0,0,3,564,184,-380
3,0,1,1,3,152,19,-133
1,0,3,4,3,152,73,-79
3,1,0,1,3,110,13,-97
1,0,3,7,3,20,17,-3
1,0,6,0,3,27,18,-9
3,0,3,0,3,40,698,658
3,1,0,0,3,61,60,-1
3,0,3,0,3,106,112,6
3,1,6,1,3,13,48,35
3,1,4,0,3,13,145,132
2,0,0,1,3,67,254,187
2,0,2,7,5,13,1,-12
3,0,0,0,3,177,74,-103
0,1,4,4,3,5,40,35
3,0,6,1,3,39,9,-30
1,0,1,0,3,55,108,53
3,0,6,2,3,2,36,34
1,0,0,4,3,38,22,-16
1,0,0,0,3,22,82,60
3,0,5,2,3,38,6,-32
1,0,2,0,5,99,130,31
3,0,1,0,3,44,68,24
0,1,3,0,3,71,33,-38
1,0,6,0,3,19,51,32
3,0,2,0,5,110,23,-87
1,0,3,6,3,15,295,280
3,0,2,0,5,51,64,13
1,0,0,0,3,55,26,-29
2,0,2,1,5,65,19,-46
1,0,3,1,3,65,299,234
1,0,0,1,3,55,68,13
3,1,1,0,3,32,61,29
3,0,6,0,3,103,56,-47
2,0,1,4,3,28,22,-6
1,0,6,0,3,36,14,-22
1,0,6,0,3,51,157,106
1,0,1,0,3,63,137,74
3,0,6,1,3,19,104,85
1,0,5,4,3,52,53,1
1,0,6,1,3,10,82,72
1,0,1,0,3,24,38,14
3,1,3,0,3,11,92,81
1,0,2,0,5,112,21,-91
3,0,3,1,3,83,3,-80
3,0,5,2,3,20,160,140
3,0,2,2,5,33,4,-29
1,0,3,1,3,98,87,-11
1,0,3,1,3,78,13,-65
1,0,2,1,3,93,45,-48
3,1,3,0,3,251,131,-120
3,0,6,1,3,34,132,98
3,0,6,0,3,41,62,21
1,0,0,7,3,5,15,10
3,1,0,7,3,36,38,2
3,0,0,1,3,134,64,-70
3,1,3,0,3,20,678,658
3,0,2,0,5,75,200,125
3,1,0,1,3,65,15,-50
1,0,1,2,3,1,61,60
1,0,0,0,3,67,89,22
1,0,2,1,5,20,68,48
3,0,2,0,5,27,130,103
3,0,0,0,3,80,86,6
1,0,3,4,3,11,24,13
3,0,3,1,3,17,255,238
3,0,0,0,3,48,22,-26
3,0,0,1,3,228,83,-145
3,1,0,0,3,51,68,17
1,0,6,1,3,12,28,16
1,0,3,0,3,69,60,-9
1,0,5,0,3,43,75,32
2,0,2,1,5,5,95,90
0,1,3,0,3,98,84,-14
1,0,3,0,3,47,62,15
3,0,2,6,5,2,4,2
2,0,2,2,5,112,58,-54
1,0,3,0,3,98,93,-5
1,0,3,4,3,51,71,20
3,1,4,1,3,176,97,-79
1,0,0,1,3,69,102,33
1,0,0,0,3,96,30,-66
1,0,6,0,3,84,37,-47
3,0,3,0,3,177,61,-116
3,0,0,1,3,31,80,49
3,1,7,5,3,3,1,-2
3,1,0,0,3,78,91,13
1,0,0,1,3,88,63,-25
2,0,0,0,3,78,70,-8
3,0,2,1,5,27,198,171
2,0,2,6,5,3,1,-2
1,0,4,0,3,68,67,-1
3,1,0,1,3,174,44,-130
1,0,6,0,3,93,43,-50
2,0,0,1,3,45,502,457
3,1,1,0,3,8,56,48
2,0,2,2,5,23,57,34
3,1,0,1,3,67,26,-41
2,0,3,4,3,18,44,26
3,0,0,1,3,23,69,46
3,0,6,0,3,53,35,-18
1,0,3,6,3,53,13,-40
3,0,2,0,5,98,24,-74
3,0,2,0,5,11,70,59
3,1,3,1,3,125,38,-87
3,0,1,2,3,23,29,6
2,0,0,0,3,133,78,-55
3,0,2,0,5,25,437,412
1,0,2,1,5,156,49,-107
3,0,0,1,3,17,126,109
3,0,2,1,5,22,78,56
3,1,0,0,3,49,209,160
3,0,0,1,3,36,190,154
3,1,4,4,3,42,10,-32
1,0,5,0,3,16,46,30
3,0,6,2,3,32,9,-23
3,1,4,0,3,51,278,227
1,0,3,0,3,122,25,-97
2,0,3,0,3,144,169,25
3,1,0,4,3,27,59,32
1,0,3,1,3,103,46,-57
3,0,6,3,3,7,12,5
2,0,2,0,5,131,72,-59
1,0,0,1,3,102,517,415
3,0,2,1,5,7,35,28
3,0,0,1,3,130,94,-36
3,1,0,1,3,43,45,2
3,0,4,1,3,129,22,-107
3,1,1,1,3,34,49,15
1,0,2,0,5,680,9,-671
3,0,3,1,3,100,7,-93
3,0,2,3,5,21,6,-15
1,0,0,0,3,752,58,-694
1,0,1,0,3,61,87,26
3,1,1,6,3,18,15,-3
3,1,3,0,3,15,80,65
3,0,2,1,5,34,86,52
1,0,3,0,3,55,138,83
3,1,0,1,3,32,84,52
1,0,6,0,3,59,77,18
3,0,5,1,3,60,22,-38
1,0,3,0,3,238,130,-108
3,0,4,2,3,32,55,23
1,0,0,0,3,73,71,-2
1,0,0,4,3,23,32,9
3,0,6,0,3,49,21,-28
3,0,3,2,3,169,117,-52
2,0,0,7,3,97,15,-82
1,0,0,0,3,181,87,-94
3,0,6,1,3,34,49,15
3,0,6,0,3,102,61,-41
3,0,4,2,3,42,113,71
3,0,2,1,5,38,6,-32
1,0,3,0,3,100,28,-72
1,0,4,0,3,118,117,-1
3,0,6,0,3,143,65,-78
3,0,3,0,3,11,38,27
1,0,0,0,3,51,64,13
3,1,0,4,3,96,127,31
3,0,5,0,3,21,15,-6
3,0,1,4,3,45,11,-34
1,0,2,1,5,25,53,28
3,0,2,0,5,97,11,-86
1,0,0,6,3,11,23,12
0,1,3,0,3,25,843,818
3,0,1,0,3,40,12,-28
1,0,3,0,3,97,163,66
0,1,3,0,3,67,30,-37
3,0,4,0,3,26,71,45
3,1,1,0,3,23,133,110
3,0,2,0,5,20,76,56
1,0,4,0,3,63,237,174
3,0,2,0,5,5,88,83
1,0,0,4,3,8,104,96
1,0,1,4,3,30,41,11
3,0,2,0,5,17,148,131
1,0,6,1,3,10,21,11
3,0,0,0,3,142,58,-84
3,0,4,1,3,61,40,-21
3,0,0,0,3,87,231,144
3,0,2,1,5,42,258,216
3,0,3,1,3,164,54,-110
3,0,2,0,5,71,4,-67
3,0,6,2,3,3,32,29
1,0,3,0,3,19,34,15
3,1,0,0,3,59,172,113
3,0,2,0,5,102,80,-22
3,1,1,4,3,33,26,-7
1,0,0,0,3,52,76,24
1,0,0,4,3,72,33,-39
3,0,0,0,3,52,82,30
1,0,0,0,3,46,33,-13
3,0,3,0,3,60,198,138
3,0,0,1,3,36,138,102
2,0,2,0,5,79,69,-10
3,0,5,1,3,2,108,106
1,0,0,1,3,60,165,105
2,0,2,2,5,29,152,123
1,0,0,1,3,71,2,-69
1,0,5,1,3,54,3,-51
3,0,6,0,3,76,39,-37
3,0,1,2,3,59,41,-18
3,0,4,1,3,24,456,432
3,0,5,0,3,87,115,28
3,1,0,0,3,262,43,-219
3,1,4,1,3,9,89,80
1,0,0,1,3,69,88,19
2,0,2,0,5,91,84,-7
1,0,6,1,3,104,1,-103
3,1,1,0,3,56,49,-7
1,0,5,0,3,76,59,-17
3,0,0,0,3,385,74,-311
3,0,2,1,5,13,45,32
1,0,0,4,3,50,18,-32
1,0,3,4,3,57,37,-20
2,0,3,0,3,61,27,-34
3,1,4,1,3,30,118,88
3,1,6,1,3,23,12,-11
1,0,0,0,3,46,131,85
2,0,0,0,3,87,93,6
1,0,3,7,5,10,3,-7
3,0,2,0,5,60,113,53
3,1,0,6,3,114,44,-70
3,0,5,0,3,106,41,-65
3,0,4,0,3,93,89,-4
3,0,5,7,5,31,1,-30
3,0,1,0,3,16,58,42
3,0,4,1,3,128,103,-25
3,0,0,0,3,86,67,-19
3,1,3,0,3,69,115,46
3,0,2,1,5,15,78,63
1,0,3,0,3,80,61,-19
3,0,3,1,3,30,150,120
3,0,2,0,5,108,18,-90
3,0,1,1,3,60,125,65
3,0,3,4,3,100,175,75
3,0,6,0,3,70,36,-34
1,0,0,0,3,35,78,43
3,0,0,0,3,621,127,-494
3,0,0,1,3,114,27,-87
3,0,6,0,3,26,46,20
3,0,2,0,5,73,28,-45
1,0,3,2,3,10,40,30
1,0,2,1,5,34,71,37
3,0,0,0,3,370,76,-294
1,0,0,4,3,78,8,-70
3,0,0,0,3,33,218,185
1,0,3,0,3,112,120,8
1,0,0,1,3,71,59,-12
3,0,3,4,3,148,65,-83
1,0,0,1,3,77,70,-7
3,1,1,0,3,109,29,-80
3,0,0,0,3,118,79,-39
3,0,0,1,3,31,91,60
1,0,2,1,5,9,47,38
1,0,3,0,3,87,73,-14
2,0,0,1,3,91,28,-63
3,0,5,2,3,70,33,-37
3,0,6,2,3,16,49,33
3,1,0,0,3,72,808,736
3,0,0,0,3,55,22,-33
1,0,2,1,5,95,158,63
3,0,0,4,3,75,26,-49
3,1,3,1,3,98,39,-59
3,1,0,0,3,45,174,129
3,0,4,1,3,143,17,-126
3,0,6,0,3,26,129,103
1,0,3,1,3,107,136,29
0,1,3,4,3,37,10,-27
3,0,0,4,3,62,17,-45
1,0,0,1,3,5,117,112
1,0,0,1,3,46,135,89
3,0,0,1,3,9,74,65
3,0,0,1,3,33,125,92
1,0,4,6,3,39,25,-14
3,0,1,1,3,42,41,-1
3,1,0,1,3,40,64,24
3,1,1,0,3,55,31,-24
1,0,0,0,3,106,74,-32
3,0,0,0,3,31,72,41
1,0,1,1,3,43,71,28
3,0,1,0,3,51,101,50
1,0,0,1,3,47,77,30
1,0,5,1,3,7,79,72
1,0,3,1,3,101,78,-23
1,0,2,1,5,88,59,-29
3,0,0,4,3,11,33,22
1,0,3,6,3,20,77,57
1,0,2,0,5,39,60,21
3,1,0,6,3,26,23,-3
1,0,2,1,5,75,22,-53
1,0,0,1,3,40,180,140
2,0,2,3,5,6,19,13
3,0,5,0,3,38,48,10
1,0,0,4,3,59,4,-55
3,0,2,0,5,40,66,26
0,1,5,1,3,9,45,36
1,0,6,0,3,33,42,9
3,0,3,0,3,3,447,444
3,0,0,0,3,50,90,40
3,0,1,0,3,72,99,27
3,0,2,0,5,104,37,-67
3,1,0,4,3,138,31,-107
3,0,5,1,3,8,14,6
2,0,2,2,5,35,6,-29
1,0,4,1,3,59,162,103
3,0,3,2,3,22,117,95
3,0,4,2,3,39,57,18
2,0,3,2,3,15,22,7
1,0,3,1,3,142,16,-126
3,1,1,1,3,80,57,-23
3,0,6,1,3,4,32,28
3,0,1,0,3,103,57,-46
3,0,6,1,3,93,33,-60
3,0,5,1,3,70,53,-17
3,1,3,0,3,104,69,-35
3,1,4,1,3,36,23,-13
3,0,0,1,3,62,119,57
3,0,2,0,5,31,13,-18
1,0,2,1,5,79,9,-70
3,0,4,4,3,596,1,-595
3,0,6,1,3,58,24,-34
2,0,2,0,5,76,9,-67
1,0,5,0,3,8,44,36
3,0,6,0,3,96,126,30
3,1,1,0,3,21,8,-13
1,0,3,1,3,146,40,-106
3,1,4,4,3,30,46,16
1,0,3,4,3,123,110,-13
1,0,5,1,3,63,52,-11
1,0,0,0,3,65,112,47
1,0,3,0,3,108,258,150
1,0,6,0,3,11,79,68
0,1,5,0,3,35,31,-4
3,0,5,0,3,20,7,-13
1,0,0,0,3,113,51,-62
3,1,1,1,3,29,14,-15
1,0,1,0,3,72,36,-36
3,0,0,4,3,65,54,-11
3,0,2,1,5,43,31,-12
3,1,0,4,3,5,47,42
2,0,0,0,3,130,93,-37
3,1,0,1,3,19,49,30
3,0,2,0,5,86,27,-59
1,0,3,0,3,7,31,24
3,0,5,2,3,22,61,39
1,0,6,0,3,17,105,88
3,0,5,0,3,51,261,210
1,0,6,6,3,2,1,-1
3,0,0,6,3,32,22,-10
3,1,0,0,3,97,46,-51
2,0,0,0,3,129,33,-96
3,0,3,0,3,351,134,-217
3,0,2,0,5,62,56,-6
2,0,2,0,5,67,66,-1
1,0,0,1,3,142,455,313
2,0,2,0,5,156,10,-146
3,0,0,4,3,70,62,-8
3,0,2,0,5,101,185,84
2,0,3,1,3,73,36,-37
3,0,2,0,5,13,82,69
3,0,6,1,3,54,8,-46
1,1,0,6,3,33,32,-1
1,0,0,1,3,258,51,-207
1,0,0,1,3,108,91,-17
1,0,6,0,3,50,16,-34
1,0,0,1,3,58,14,-44
2,0,0,0,3,83,214,131
3,0,0,2,3,30,59,29
1,0,0,1,3,30,87,57
3,1,0,0,3,144,37,-107
2,0,2,0,5,22,382,360
3,1,3,6,3,10,98,88
1,0,1,4,3,59,10,-49
1,0,0,0,3,702,85,-617
3,1,0,4,3,27,42,15
1,0,6,1,3,59,32,-27
1,0,3,0,3,11,100,89
3,0,6,1,3,15,41,26
3,0,2,0,5,127,121,-6
3,1,3,1,3,48,106,58
2,0,2,0,5,50,869,819
3,0,6,1,3,46,4,-42
3,0,2,0,5,6,74,68
1,0,0,6,3,47,138,91
1,0,2,0,5,70,57,-13
3,0,3,1,3,59,15,-44
3,0,6,3,3,3,18,15
3,0,3,6,3,32,42,10
3,0,6,2,3,17,8,-9
1,0,6,1,3,103,3,-100
3,0,0,1,3,87,14,-73
1,0,3,0,3,52,26,-26
3,0,3,1,3,129,60,-69
3,0,1,0,3,106,98,-8
1,0,0,0,3,550,43,-507
3,1,5,0,3,61,102,41
1,0,3,0,3,365,80,-285
3,0,6,3,3,6,10,4
1,0,0,1,3,39,150,111
3,0,6,1,3,44,14,-30
3,1,3,0,3,101,58,-43
1,0,0,0,3,38,52,14
3,0,2,1,5,195,11,-184
1,0,0,0,3,34,103,69
3,0,0,0,3,89,82,-7
1,0,6,0,3,48,44,-4
3,0,0,0,3,49,98,49
1,0,0,1,3,100,198,98
3,0,1,0,3,74,266,192
1,0,6,1,3,5,25,20
2,0,0,1,3,9,81,72
2,0,2,0,5,70,15,-55
3,1,0,1,3,92,7,-85
1,0,6,3,3,19,9,-10
3,1,0,0,3,133,458,325
3,0,3,5,3,94,20,-74
1,0,2,1,5,117,5,-112
3,0,0,6,3,53,40,-13
1,0,4,2,3,41,11,-30
3,0,2,0,5,2,97,95
3,0,6,1,3,38,13,-25
3,1,0,0,3,107,63,-44
3,0,1,1,3,32,102,70
1,0,3,6,3,32,109,77
1,0,0,7,3,58,35,-23
3,0,3,1,3,164,170,6
1,0,0,0,3,69,100,31
1,0,5,0,3,19,25,6
1,0,2,0,5,76,89,13
3,1,0,0,3,48,41,-7
3,0,6,0,3,53,58,5
3,0,5,3,3,1,20,19
1,0,0,0,3,69,102,33
3,0,0,0,3,139,104,-35
3,1,4,0,3,48,23,-25
3,0,2,4,5,1,7,6
3,0,0,0,3,67,82,15
1,0,5,0,3,6,136,130
3,0,2,0,5,16,61,45
3,0,2,0,5,44,48,4
3,0,2,4,5,3,49,46
3,0,4,1,3,416,47,-369
3,0,1,6,3,13,117,104
1,0,6,0,3,32,13,-19
1,0,0,1,3,33,134,101
3,0,0,0,3,56,82,26
3,0,2,1,5,21,53,32
2,0,2,0,5,42,90,48
3,1,0,0,3,59,171,112
3,1,0,1,3,89,20,-69
1,0,0,4,3,92,14,-78
3,0,6,1,3,78,28,-50
3,0,6,1,3,47,41,-6
0,1,3,0,3,168,4,-164
3,0,0,1,3,31,72,41
3,0,5,4,3,5,26,21
1,0,4,2,3,20,8,-12
1,0,2,1,5,80,88,8
3,1,0,1,3,93,21,-72
1,0,2,2,5,15,155,140
1,0,0,1,3,58,61,3
3,0,5,1,3,56,14,-42
3,1,7,5,3,4,1,-3
1,0,3,4,3,308,69,-239
1,0,0,0,3,59,36,-23
2,0,2,4,5,5,13,8
3,1,1,0,3,25,351,326
0,1,3,1,3,89,122,33
2,0,3,0,3,118,50,-68
1,0,4,1,3,83,134,51
2,0,1,1,3,42,5,-37
2,0,2,1,5,30,56,26
1,0,1,1,3,77,65,-12
1,0,3,1,3,81,601,520
1,0,0,0,3,62,101,39
3,0,6,1,3,37,11,-26
3,0,1,0,3,37,73,36
2,0,0,1,3,126,25,-101
1,0,0,1,3,85,62,-23
0,1,3,1,3,22,43,21
1,0,2,2,5,4,63,59
3,0,0,0,3,29,100,71
2,0,3,1,3,72,126,54
1,0,3,6,3,19,15,-4
1,0,0,0,3,105,129,24
3,0,3,0,3,35,71,36
3,0,5,3,3,25,7,-18
1,0,4,1,3,20,113,93
2,0,3,1,3,86,4,-82
3,0,3,0,3,10,43,33
3,0,4,6,3,13,14,1
1,0,0,1,3,153,16,-137
3,0,3,0,3,60,210,150
3,0,5,0,3,42,17,-25
3,0,4,0,3,95,98,3
1,0,6,1,3,3,49,46
3,0,0,1,3,45,22,-23
1,0,6,2,3,2,17,15
3,0,2,1,5,16,91,75
3,0,1,0,3,52,76,24
2,0,3,4,3,81,26,-55
3,0,5,1,3,28,47,19
2,0,3,4,3,176,113,-63
2,0,2,0,5,76,68,-8
2,0,3,0,3,64,185,121
3,1,0,0,3,42,127,85
1,0,0,4,3,10,101,91
3,0,0,7,3,8,70,62
3,1,4,7,3,125,28,-97
1,0,3,1,3,200,132,-68
3,0,3,0,3,28,61,33
1,0,4,4,3,17,4,-13
0,1,3,0,3,4,53,49
3,1,0,1,3,82,84,2
2,0,2,3,5,99,14,-85
3,0,2,0,5,76,59,-17
3,0,1,0,3,131,73,-58
3,0,2,0,5,35,150,115
3,0,0,0,3,37,64,27
3,1,3,0,3,129,592,463
3,0,2,1,5,3,189,186
3,1,1,0,3,47,1,-46
3,1,5,2,3,28,54,26
3,0,6,2,3,32,9,-23
1,0,0,6,3,53,112,59
3,0,6,1,3,33,49,16
1,0,3,0,3,129,150,21
2,0,2,0,5,33,43,10
2,0,1,4,3,44,42,-2
3,0,0,0,3,285,87,-198
1,0,2,0,5,39,19,-20
3,0,3,1,3,85,17,-68
1,0,2,1,5,25,58,33
3,0,6,1,3,3,48,45
3,0,5,0,3,17,81,64
3,0,6,1,3,33,67,34
2,0,2,0,5,13,80,67
1,0,0,1,3,54,124,70
3,0,6,0,3,46,231,185
3,0,2,0,5,51,43,-8
3,0,2,1,5,10,90,80
3,0,2,1,5,14,93,79
2,0,3,0,3,125,76,-49
2,0,0,0,3,102,53,-49
1,0,0,0,3,95,57,-38
1,0,6,0,3,555,59,-496
1,0,5,1,3,32,4,-28
1,0,0,1,3,30,85,55
3,1,0,6,3,5,52,47
1,0,1,2,3,84,49,-35
2,0,1,0,3,3,32,29
3,1,0,6,3,82,10,-72
3,1,7,5,3,5,2,-3
0,1,5,2,3,8,9,1
3,0,0,2,3,65,42,-23
3,0,1,0,3,46,62,16
3,0,4,1,3,5,101,96
2,0,2,0,5,34,136,102
2,0,1,1,3,22,52,30
1,0,0,1,3,94,183,89
3,1,3,1,3,14,62,48
3,0,2,6,5,5,7,2
1,0,3,4,3,43,51,8
1,0,3,0,3,179,37,-142
1,0,2,0,5,32,46,14
3,0,2,2,5,86,21,-65
1,0,5,2,3,8,23,15
3,0,5,1,3,21,47,26
3,1,0,1,3,68,4,-64
3,0,4,0,3,108,67,-41
2,0,0,0,3,24,105,81
2,0,0,2,3,63,7,-56
1,0,0,1,3,57,89,32
3,0,3,1,3,129,96,-33
3,0,6,1,3,66,30,-36
3,0,6,2,3,10,23,13
3,0,1,0,3,41,1,-40
3,0,2,0,5,94,68,-26
3,0,0,0,3,5,65,60
3,0,2,0,5,352,119,-233
1,0,2,7,5,2,4,2
3,0,6,1,3,47,2,-45
2,0,0,0,3,136,163,27
3,1,0,1,3,20,112,92
3,0,3,2,3,234,45,-189
3,1,0,6,3,16,68,52
3,0,3,0,3,42,154,112
3,0,2,1,5,153,52,-101
1,0,2,0,5,76,68,-8
3,1,5,6,3,21,18,-3
3,0,6,1,3,58,33,-25
3,0,2,4,5,1,8,7
3,1,1,0,3,20,21,1
3,0,6,4,3,5,37,32
3,1,0,6,3,17,98,81
3,0,1,1,3,39,7,-32
1,0,3,1,3,524,24,-500
1,0,6,0,3,73,31,-42
1,0,2,2,5,31,5,-26
1,0,3,6,3,47,29,-18
3,1,5,4,3,29,11,-18
2,0,0,0,3,239,67,-172
3,0,6,1,3,77,17,-60
3,1,0,1,3,105,34,-71
3,0,3,0,3,134,110,-24
1,0,0,0,3,53,80,27
3,0,6,0,3,72,113,41
3,0,6,1,3,33,88,55
3,0,3,0,3,29,98,69
3,0,2,1,5,29,53,24
3,0,2,3,5,84,4,-80
3,0,6,0,3,305,50,-255
1,0,5,0,3,37,31,-6
3,0,6,3,3,55,14,-41
1,0,4,2,3,64,33,-31
1,0,3,0,3,200,26,-174
1,0,6,1,3,7,87,80
2,0,2,0,5,195,30,-165
1,0,0,1,3,303,12,-291
2,0,2,2,5,107,20,-87
3,0,0,6,3,99,14,-85
3,1,1,0,3,3,84,81
3,0,2,1,5,80,204,124
2,0,0,1,3,167,83,-84
1,0,3,0,3,70,85,15
3,0,1,1,3,65,21,-44
3,0,3,5,3,81,94,13
3,1,1,0,3,11,17,6
1,0,3,0,3,101,93,-8
1,0,3,6,3,52,77,25
3,1,0,0,3,90,40,-50
3,1,0,1,3,57,18,-39
1,0,3,7,3,55,68,13
1,0,4,1,3,121,7,-114
3,0,2,0,5,53,15,-38
3,0,1,0,3,12,19,7
1,0,2,0,5,8,146,138
3,1,0,0,3,836,70,-766
3,0,1,4,3,34,7,-27
3,0,2,0,5,122,125,3
3,1,0,0,3,280,46,-234
1,0,0,0,3,259,133,-126
1,0,3,1,3,37,32,-5
1,0,2,0,5,79,65,-14
1,0,6,1,3,9,49,40
3,0,6,1,3,39,8,-31
1,0,0,0,3,131,134,3
3,0,3,4,3,110,260,150
1,0,3,1,3,91,37,-54
3,0,2,0,5,60,25,-35
2,0,2,1,5,57,14,-43
3,0,6,4,3,31,2,-29
1,0,0,0,3,74,78,4
1,0,3,0,3,36,72,36
3,1,5,0,3,20,65,45
1,0,3,1,3,89,76,-13
3,0,3,4,3,104,57,-47
3,0,1,0,3,13,221,208
3,1,1,0,3,67,57,-10
1,0,5,2,3,28,5,-23
2,0,1,0,3,32,9,-23
1,0,6,2,3,30,6,-24
3,0,0,1,3,11,60,49
3,0,5,1,3,66,9,-57
3,1,1,0,3,42,352,310
3,0,2,2,5,7,34,27
1,0,0,6,3,10,136,126
1,0,2,0,5,13,75,62
3,0,6,1,3,15,26,11
1,0,0,0,3,99,86,-13
3,0,3,0,3,42,45,3
1,0,0,4,3,50,71,21
1,0,3,1,3,134,73,-61
1,0,3,0,3,140,59,-81
3,0,4,1,3,116,67,-49
3,1,0,6,3,14,18,4
1,0,0,1,3,26,64,38
2,0,3,4,3,202,4,-198
3,1,1,4,3,5,11,6
1,0,3,6,3,59,93,34
1,0,2,1,5,87,30,-57
3,0,1,1,3,10,47,37
2,0,0,1,3,118,105,-13
3,0,6,1,3,9,48,39
2,0,2,2,5,48,1,-47
1,0,4,0,3,251,127,-124
3,0,2,1,5,114,44,-70
3,0,2,0,5,39,105,66
3,0,2,0,5,41,172,131
1,0,3,0,3,69,46,-23
1,0,0,0,3,74,52,-22
3,0,6,1,3,60,12,-48
3,0,0,1,3,55,10,-45
1,0,1,1,3,146,60,-86
3,1,0,0,3,97,61,-36
0,1,5,2,3,4,22,18
3,1,1,0,3,86,5,-81
3,0,6,2,3,114,18,-96
1,0,4,0,3,58,21,-37
1,0,0,1,3,5,55,50
3,0,6,0,3,24,93,69
1,0,3,0,3,421,38,-383
3,0,1,0,3,2,33,31
3,1,3,1,3,173,9,-164
3,1,0,6,3,5,34,29
2,0,3,7,3,21,65,44
1,0,4,2,3,98,13,-85
3,0,2,3,5,16,31,15
1,0,2,7,5,2,1,-1
1,0,0,0,3,108,349,241
3,0,1,1,3,13,100,87
1,0,4,0,3,58,53,-5
3,0,2,4,5,12,1,-11
3,1,3,0,3,919,557,-362
2,0,2,3,5,21,1,-20
1,0,0,1,3,61,15,-46
3,0,4,1,3,84,27,-57
3,0,6,2,3,248,4,-244
3,0,0,0,3,31,69,38
1,0,0,0,3,31,382,351
3,0,0,0,3,108,97,-11
3,1,5,4,3,1,40,39
3,0,1,0,3,7,122,115
3,0,5,1,3,11,49,38
1,0,2,0,5,107,35,-72
3,1,0,0,3,128,76,-52
3,1,0,0,3,148,121,-27
3,0,5,4,3,51,14,-37
2,0,3,1,3,245,47,-198
2,0,0,0,3,86,85,-1
3,0,3,0,3,129,48,-81
3,0,3,4,3,18,51,33
3,0,6,3,3,89,3,-86
2,0,2,0,5,63,16,-47
3,0,6,1,3,11,80,69
3,1,0,6,3,55,54,-1
1,0,6,1,3,4,38,34
1,0,2,2,5,19,17,-2
3,0,6,1,3,56,16,-40
3,0,2,1,5,147,13,-134
1,0,0,4,3,78,166,88
0,1,3,0,3,10,49,39
3,1,3,0,3,76,29,-47
3,0,0,6,3,29,31,2
3,1,1,0,3,23,31,8
1,0,4,2,3,185,28,-157
3,1,0,1,3,33,73,40
3,1,0,4,3,141,59,-82
3,0,1,0,3,39,23,-16
1,0,2,1,5,2,148,146
3,1,5,1,3,8,35,27
3,0,0,4,3,29,126,97
3,0,6,1,3,32,55,23
3,0,5,2,3,13,48,35
1,0,4,1,3,16,333,317
1,0,5,1,3,105,13,-92
2,0,1,1,3,23,15,-8
3,0,6,1,3,13,55,42
3,0,0,4,3,72,24,-48
3,0,6,2,3,34,16,-18
3,1,1,0,3,37,441,404
3,0,3,0,3,67,17,-50
3,0,4,1,3,115,43,-72
3,0,5,4,3,26,16,-10
3,0,0,0,3,81,61,-20
3,0,2,0,5,52,105,53
3,0,0,1,3,56,115,59
3,0,2,2,5,2,49,47
1,0,0,4,3,5,199,194
2,0,2,0,5,191,20,-171
3,1,0,1,3,17,129,112
1,0,3,0,3,321,83,-238
3,0,6,1,3,44,10,-34
3,0,0,4,3,160,145,-15
3,0,3,0,3,65,15,-50
3,0,2,1,5,65,5,-60
3,0,5,1,3,25,80,55
1,0,0,4,3,106,30,-76
3,0,2,1,5,50,15,-35
2,0,3,1,3,30,92,62
3,0,0,2,3,72,46,-26
2,0,0,0,3,66,45,-21
2,0,1,0,3,9,37,28
3,0,1,1,3,17,225,208
3,0,6,7,3,22,3,-19
1,0,5,1,3,34,71,37
1,0,3,1,3,122,59,-63
1,0,0,1,3,236,23,-213
3,1,3,0,3,113,48,-65
1,0,6,0,3,251,20,-231
2,0,2,0,5,64,46,-18
3,0,2,4,5,19,33,14
1,0,3,4,3,10,72,62
3,1,0,1,3,64,16,-48
1,0,4,0,3,36,55,19
2,0,0,1,3,116,47,-69
3,0,2,1,5,73,13,-60
2,0,1,0,3,35,15,-20
3,0,1,1,3,69,12,-57
1,0,3,0,3,117,116,-1
3,0,6,1,3,56,21,-35
1,0,1,0,3,42,65,23
3,0,2,3,5,28,8,-20
1,0,1,4,3,5,45,40
3,0,0,6,3,105,60,-45
3,1,4,6,3,3,28,25
3,0,5,2,3,9,34,25
3,1,4,0,3,60,176,116
3,1,3,1,3,424,89,-335
1,0,3,0,3,37,123,86
3,0,6,2,3,60,11,-49
3,0,6,2,3,132,26,-106
2,0,0,0,3,102,79,-23
1,0,1,0,3,113,85,-28
3,0,6,4,3,4,12,8
3,0,3,0,3,67,55,-12
3,1,4,4,3,18,138,120
3,0,0,0,3,201,35,-166
3,0,3,4,3,21,12,-9
1,0,0,6,3,68,42,-26
1,0,0,0,3,54,481,427
3,1,0,0,3,104,98,-6
3,0,0,0,3,43,50,7
2,0,0,4,3,12,17,5
3,0,6,1,3,60,19,-41
3,1,3,0,3,1084,22,-1062
3,0,5,4,3,21,2,-19
2,0,2,0,5,13,49,36
3,1,5,7,3,25,1,-24
3,0,6,1,3,14,93,79
3,0,2,2,5,39,24,-15
1,0,4,0,3,65,79,14
1,0,5,0,3,55,103,48
3,0,6,0,3,46,225,179
1,0,2,0,5,452,126,-326
1,1,0,1,3,96,27,-69
1,0,0,0,3,38,69,31
3,0,3,0,3,224,82,-142
3,0,2,1,5,78,10,-68
3,0,0,1,3,40,120,80
3,1,7,5,3,1,10,9
1,0,3,4,3,75,3,-72
3,0,4,4,3,49,2,-47
1,0,0,6,3,40,96,56
3,1,4,1,3,23,178,155
3,0,4,1,3,82,64,-18
1,0,1,1,3,36,191,155
3,0,6,0,3,77,85,8
1,0,6,4,3,5,10,5
3,0,2,0,5,14,92,78
0,1,3,4,3,8,12,4
3,1,1,0,3,11,45,34
3,0,6,0,3,106,46,-60
3,1,4,1,3,18,139,121
1,0,5,0,3,23,45,22
3,0,2,3,5,68,5,-63
3,0,5,0,3,36,53,17
0,1,3,0,3,8,169,161
1,0,0,0,3,90,133,43
3,1,0,1,3,36,79,43
1,0,2,1,5,132,32,-100
3,1,3,0,3,95,91,-4
1,0,2,2,5,25,16,-9
2,0,0,1,3,83,41,-42
3,0,6,0,3,130,87,-43
3,1,3,0,3,18,84,66
3,0,6,0,3,1067,38,-1029
2,0,2,0,5,178,23,-155
3,0,3,0,3,360,94,-266
3,1,0,6,3,11,17,6
3,0,3,6,3,38,4,-34
3,1,7,5,3,5,3,-2
3,0,6,0,3,118,59,-59
1,0,6,0,3,57,40,-17
1,0,3,1,3,53,69,16
1,0,1,0,3,26,93,67
1,0,5,4,3,13,23,10
3,1,3,0,3,228,84,-144
3,0,2,0,5,28,122,94
3,0,1,0,3,43,92,49
3,0,3,0,3,49,437,388
3,1,0,1,3,112,15,-97
3,0,2,0,5,61,3,-58
3,0,2,1,5,120,7,-113
1,0,2,0,5,285,50,-235
1,0,5,0,3,11,63,52
2,0,2,2,5,14,121,107
3,0,0,1,3,108,85,-23
1,0,2,1,5,5,103,98
3,0,3,2,3,94,16,-78
3,0,4,1,3,57,97,40
3,1,3,4,3,26,72,46
3,1,1,6,3,13,3,-10
3,1,6,0,3,66,30,-36
1,0,1,0,3,125,51,-74
3,0,6,1,3,27,103,76
1,0,2,3,5,12,6,-6
3,0,2,0,5,93,112,19
3,0,0,4,3,91,30,-61
1,0,3,0,3,15,47,32
1,0,2,0,5,11,132,121
1,0,4,1,3,132,57,-75
3,0,6,1,3,232,7,-225
1,0,0,6,3,15,63,48
3,0,3,1,3,70,48,-22
1,0,4,0,3,58,82,24
2,0,2,0,5,136,151,15
1,0,2,3,5,23,2,-21
3,0,2,1,5,29,123,94
1,0,3,0,3,61,1511,1450
3,1,3,1,3,98,130,32
1,0,5,0,3,7,94,87
2,0,2,0,5,81,13,-68
3,0,1,0,3,44,96,52
1,0,3,4,3,29,56,27
3,0,6,0,3,20,155,135
3,1,0,4,3,75,83,8
3,0,3,4,3,44,89,45
3,0,5,1,3,4,39,35
3,1,3,6,3,80,38,-42
1,0,0,1,3,131,139,8
3,0,6,0,3,52,61,9
1,0,3,0,3,169,79,-90
1,0,6,1,3,42,2,-40
1,0,6,1,3,7,82,75
3,0,6,1,3,124,6,-118
3,0,2,1,5,65,28,-37
2,0,1,0,3,60,55,-5
3,1,5,1,3,37,7,-30
2,0,3,4,3,112,21,-91
3,0,6,1,3,20,83,63
1,0,0,1,3,41,13,-28
2,0,2,2,5,47,2,-45
1,0,3,0,3,27,204,177
3,0,2,0,5,31,57,26
1,0,6,6,3,36,3,-33
2,0,1,0,3,117,17,-100
3,0,5,2,3,34,68,34
3,0,2,0,5,86,15,-71
3,0,6,2,3,18,3,-15
1,0,0,1,3,14,63,49
1,0,1,0,3,81,94,13
1,0,3,5,3,66,131,65
3,0,0,0,3,36,502,466
3,0,4,0,3,62,208,146
1,0,2,0,5,75,17,-58
3,0,3,1,3,109,37,-72
3,0,0,4,3,52,60,8
3,0,2,3,5,10,7,-3
3,1,6,1,3,53,10,-43
3,0,6,6,3,2,7,5
3,0,2,0,5,34,133,99
3,0,0,0,3,114,107,-7
3,0,5,2,3,4,27,23
1,0,6,0,3,42,37,-5
3,1,6,6,3,2,3,1
1,0,6,2,3,6,27,21
3,0,6,7,3,13,4,-9
3,0,3,0,3,7,168,161
3,1,4,0,3,90,109,19
3,0,3,1,3,60,156,96
1,0,4,1,3,63,77,14
2,0,2,0,5,66,12,-54
3,0,4,0,3,25,41,16
3,1,0,4,3,37,10,-27
3,0,6,1,3,11,42,31
3,0,2,0,5,181,40,-141
3,0,1,1,3,46,58,12
1,0,0,1,3,138,129,-9
3,1,7,5,3,9,1,-8
3,0,0,1,3,54,47,-7
3,0,1,0,3,6,21,15
3,0,2,0,5,15,51,36
3,0,0,0,3,141,76,-65
1,0,4,0,3,75,30,-45
3,0,2,0,5,12,122,110
1,0,4,0,3,192,90,-102
1,0,2,0,5,33,50,17
3,1,3,0,3,79,102,23
1,0,2,0,5,72,6,-66
2,0,1,0,3,68,356,288
2,0,2,2,5,15,41,26
3,0,1,0,3,22,113,91
1,0,3,0,3,76,79,3
3,0,4,0,3,61,31,-30
2,0,2,1,5,75,32,-43
3,0,0,1,3,94,72,-22
3,1,0,1,3,52,19,-33
3,1,1,0,3,14,85,71
3,0,1,1,3,37,61,24
3,0,6,0,3,24,62,38
3,0,3,7,3,5,38,33
3,0,5,0,3,16,35,19
3,0,2,0,5,11,42,31
3,1,3,0,3,72,100,28
1,0,2,3,5,13,43,30
3,0,0,1,3,332,31,-301
3,0,6,1,3,158,8,-150
2,0,2,0,5,209,102,-107
3,0,0,0,3,128,136,8
1,0,1,6,3,14,100,86
3,1,0,1,3,95,23,-72
2,0,2,4,5,18,8,-10
1,0,1,1,3,153,106,-47
3,1,3,0,3,88,73,-15
1,0,2,0,5,101,96,-5
3,0,1,4,3,53,8,-45
1,0,3,6,3,9,95,86
3,0,0,0,3,100,40,-60
1,0,1,0,3,439,261,-178
1,0,2,3,5,6,82,76
3,0,4,1,3,503,124,-379
2,0,1,0,3,19,63,44
1,0,0,0,3,54,52,-2
3,1,0,0,3,62,110,48
3,0,6,2,3,21,1,-20
1,0,0,0,3,113,421,308
3,0,2,0,5,58,76,18
3,0,5,0,3,4,32,28
1,0,3,0,3,132,19,-113
3,0,6,0,3,63,71,8
1,0,4,0,3,99,106,7
1,0,6,2,3,10,42,32
3,0,0,0,3,35,68,33
1,0,0,0,3,43,83,40
2,0,2,6,5,2,16,14
3,0,6,0,3,42,13,-29
3,1,4,1,3,37,125,88
3,0,6,2,3,72,92,20
3,0,1,0,3,38,92,54
1,0,1,0,3,33,104,71
3,0,2,0,5,168,4,-164
3,0,3,4,3,11,88,77
3,0,6,1,3,72,15,-57
3,0,2,0,5,64,18,-46
3,0,6,0,3,56,289,233
2,0,2,2,5,1,123,122
3,0,2,0,5,74,48,-26
3,0,6,1,3,8,103,95
1,0,2,0,5,37,85,48
3,0,5,0,3,52,50,-2
3,1,7,5,3,13,4,-9
3,0,2,0,5,37,41,4
1,0,6,1,3,20,106,86
3,0,4,0,3,587,90,-497
3,0,0,1,3,144,1,-143
2,0,3,4,3,96,100,4
3,0,3,0,3,8,23,15
1,0,3,0,3,140,115,-25
1,0,0,0,3,81,34,-47
3,0,5,0,3,13,24,11
3,1,0,6,3,9,22,13
1,0,1,2,3,155,17,-138
3,0,6,1,3,28,13,-15
3,0,0,7,3,19,49,30
1,0,0,0,3,136,108,-28
3,0,3,1,3,57,62,5
3,0,0,0,3,117,147,30
3,0,0,4,3,18,36,18
3,1,0,0,3,89,63,-26
3,0,3,1,3,62,27,-35
3,0,5,1,3,33,65,32
3,1,0,0,3,158,64,-94
2,0,2,2,5,29,37,8
1,0,0,4,3,49,125,76
3,0,2,1,5,45,18,-27
1,0,6,0,3,23,42,19
1,0,0,4,3,7,23,16
3,0,6,1,3,15,98,83
3,1,3,0,3,91,5,-86
1,0,0,1,3,123,102,-21
2,0,2,1,5,85,69,-16
3,0,6,0,3,144,108,-36
1,0,6,4,3,6,2,-4
3,0,1,0,3,14,65,51
3,0,0,1,3,45,15,-30
3,0,0,0,3,59,865,806
3,0,2,1,5,48,81,33
0,1,5,1,3,37,4,-33
3,0,4,1,3,89,40,-49
3,0,2,1,5,1,74,73
3,1,0,1,3,49,23,-26
3,1,0,0,3,37,138,101
1,0,3,0,3,233,88,-145
1,0,2,1,5,3,89,86
3,0,4,7,3,30,33,3
3,0,3,0,3,182,96,-86
1,0,0,0,3,64,51,-13
1,0,3,1,3,53,129,76
3,0,1,0,3,29,64,35
3,0,5,0,3,29,5,-24
1,0,2,1,5,40,6,-34
1,0,2,0,5,34,49,15
3,1,6,1,3,52,16,-36
3,0,0,0,3,136,51,-85
3,0,3,1,3,88,155,67
1,0,4,2,3,41,25,-16
3,0,2,0,5,12,303,291
3,1,0,0,3,66,70,4
3,0,5,0,3,55,85,30
3,0,2,0,5,23,32,9
2,0,0,4,3,167,19,-148
1,0,0,7,3,109,39,-70
3,0,2,0,5,36,31,-5
1,0,3,1,3,121,370,249
2,0,2,0,5,36,76,40
3,1,0,0,3,89,29,-60
2,0,0,0,3,176,30,-146
3,0,6,2,3,24,13,-11
1,0,0,6,3,43,72,29
1,0,6,1,3,7,56,49
3,0,6,0,3,46,247,201
1,0,1,1,3,23,42,19
3,0,1,0,3,78,233,155
3,1,1,0,3,36,43,7
3,0,1,0,3,51,44,-7
0,1,3,0,3,21,11,-10
3,0,2,0,5,94,33,-61
1,0,2,0,5,3,57,54
1,0,6,2,3,18,10,-8
3,0,4,1,3,45,141,96
3,0,4,0,3,194,53,-141
1,0,3,0,3,80,16,-64
1,0,0,1,3,134,81,-53
2,0,2,4,5,26,22,-4
1,0,3,1,3,55,82,27
3,0,3,4,3,32,40,8
3,0,6,0,3,22,39,17
3,0,6,0,3,54,27,-27
2,0,2,0,5,50,211,161
2,0,3,0,3,76,109,33
1,0,1,0,3,144,33,-111
2,0,2,0,5,19,33,14
3,0,0,1,3,40,80,40
1,0,4,7,5,2,28,26
3,0,2,0,5,94,157,63
1,0,0,4,3,87,24,-63
3,0,5,0,3,79,69,-10
3,0,3,1,3,133,57,-76
0,1,5,1,3,9,85,76
3,0,3,0,3,26,178,152
3,0,5,0,3,58,68,10
3,0,2,1,5,5,63,58
1,0,3,0,3,91,85,-6
3,0,3,0,3,114,134,20
1,0,3,1,3,486,46,-440
3,1,0,1,3,93,76,-17
1,0,3,0,3,24,43,19
1,0,2,0,5,11,102,91
1,0,1,0,3,65,84,19
3,0,5,1,3,18,26,8
3,0,3,6,3,1,45,44
3,0,2,7,5,1,9,8
3,0,6,0,3,56,50,-6
3,0,3,1,3,62,19,-43
1,0,2,0,5,237,231,-6
1,0,1,1,3,36,28,-8
3,1,1,1,3,63,15,-48
1,1,0,7,3,22,118,96
3,0,1,4,3,14,6,-8
2,0,2,2,5,11,51,40
1,0,0,1,3,57,118,61
1,0,3,1,3,96,27,-69
1,0,2,1,5,49,60,11
3,0,2,1,5,62,68,6
3,0,6,0,3,87,20,-67
3,0,6,0,3,132,139,7
3,0,2,0,5,84,43,-41
1,0,1,1,3,25,41,16
3,0,1,1,3,30,86,56
1,0,3,0,3,60,29,-31
1,0,2,0,5,205,24,-181
3,0,1,0,3,92,35,-57
1,0,0,1,3,71,6,-65
2,0,1,0,3,21,99,78
2,0,3,1,3,32,208,176
3,0,1,0,3,37,133,96
3,0,3,0,3,64,21,-43
3,1,1,1,3,11,42,31
3,0,6,1,3,101,14,-87
3,0,2,2,5,109,12,-97
1,0,0,0,3,32,43,11
1,0,6,1,3,29,49,20
3,0,0,0,3,66,135,69
1,0,0,4,3,34,124,90
1,0,4,0,3,120,46,-74
3,0,0,0,3,439,63,-376
3,0,2,1,5,51,20,-31
3,0,3,0,3,79,142,63
1,0,1,1,3,23,91,68
3,1,4,1,3,13,74,61
1,0,0,0,3,81,37,-44
3,0,0,0,3,272,91,-181
3,0,0,4,3,25,119,94
3,1,5,0,3,58,44,-14
1,0,5,2,3,65,27,-38
3,1,6,4,3,11,17,6
2,0,2,0,5,123,25,-98
3,0,1,7,3,3,72,69
1,0,5,1,3,44,16,-28
3,0,4,1,3,64,73,9
3,0,2,1,5,68,41,-27
1,0,2,0,5,15,88,73
3,0,5,1,3,57,16,-41
3,1,0,1,3,17,96,79
3,1,4,1,3,32,11,-21
3,1,3,4,3,50,1,-49
3,1,0,0,3,129,54,-75
3,1,0,0,3,154,60,-94
1,0,5,4,3,1,7,6
0,1,3,1,3,190,7,-183
3,0,2,0,5,5,82,77
1,0,3,4,3,82,102,20
1,0,0,1,3,86,38,-48
3,0,2,1,5,75,30,-45
3,1,0,0,3,112,71,-41
1,0,2,0,5,27,129,102
3,0,2,0,5,70,3,-67
3,0,3,0,3,73,69,-4
0,1,3,4,3,133,35,-98
1,0,6,0,3,97,30,-67
3,0,2,3,5,3,54,51
1,0,0,4,3,10,106,96
3,0,4,0,3,178,238,60
2,0,2,1,5,33,115,82
1,0,0,0,3,14,149,135
3,0,3,1,3,66,106,40
3,0,2,1,5,5,69,64
0,1,3,0,3,40,32,-8
1,0,3,0,3,67,47,-20
3,1,6,1,3,3,25,22
1,0,6,0,3,38,93,55
1,0,3,6,3,93,31,-62
3,0,2,0,5,85,27,-58
3,0,3,4,3,14,125,111
3,1,3,0,3,47,32,-15
3,0,1,0,3,97,41,-56
3,1,0,4,3,58,46,-12
1,0,0,0,3,155,44,-111
3,0,0,0,3,105,40,-65
3,0,5,1,3,30,69,39
3,0,2,3,5,34,5,-29
1,0,2,1,5,33,1,-32
3,0,6,2,3,53,23,-30
1,0,5,0,3,3,49,46
1,0,6,0,3,98,12,-86
1,0,0,0,3,108,143,35
3,0,3,4,3,1,25,24
3,0,0,0,3,203,67,-136
3,1,0,0,3,113,39,-74
3,0,3,6,3,18,30,12
3,1,3,0,3,37,54,17
1,0,0,7,3,15,29,14
3,0,0,4,3,73,53,-20
1,0,3,0,3,40,441,401
2,0,3,1,3,75,22,-53
3,0,4,1,3,128,28,-100
3,0,1,0,3,40,42,2
3,1,3,1,3,21,175,154
2,0,3,0,3,109,229,120
3,1,0,0,3,34,75,41
1,0,5,1,3,29,26,-3
1,0,6,6,3,5,1,-4
3,1,0,6,3,12,32,20
3,0,0,0,3,2,168,166
3,0,2,0,5,55,13,-42
1,0,0,0,3,136,49,-87
1,0,1,6,3,78,59,-19
1,0,0,0,3,87,67,-20
3,0,0,4,3,44,84,40
3,0,3,4,3,102,21,-81
3,0,6,1,3,96,27,-69
3,0,5,1,3,76,10,-66
3,0,6,6,3,14,1,-13
3,0,1,0,3,26,237,211
3,1,3,1,3,76,92,16
1,0,2,0,5,173,10,-163
1,0,2,1,5,23,130,107
3,1,0,0,3,166,44,-122
3,0,0,7,3,42,53,11
3,0,6,0,3,61,73,12
3,0,0,1,3,76,25,-51
3,0,2,0,5,13,103,90
3,0,1,0,3,67,51,-16
3,0,5,1,3,14,54,40
1,0,0,1,3,42,242,200
3,0,6,0,3,43,42,-1
2,0,2,0,5,51,212,161
3,0,2,0,5,23,146,123
2,0,2,2,5,73,4,-69
3,0,6,3,3,113,2,-111
3,0,1,7,3,14,15,1
2,0,2,0,5,34,149,115
3,1,3,1,3,53,153,100
3,0,2,0,5,76,116,40
1,0,3,1,3,48,19,-29
1,0,3,6,3,14,8,-6
3,0,2,1,5,132,13,-119
3,0,2,2,5,142,13,-129
3,0,2,0,5,32,94,62
2,0,3,0,3,36,97,61
3,0,6,1,3,43,4,-39
1,0,3,0,3,187,82,-105
3,0,1,6,3,1,4,3
1,0,3,0,3,932,98,-834
3,1,0,1,3,79,18,-61
1,0,5,0,3,49,41,-8
3,0,2,2,5,62,7,-55
3,0,2,0,5,105,12,-93
3,0,2,6,5,3,2,-1
3,1,0,0,3,325,62,-263
2,0,3,0,3,85,58,-27
0,1,3,0,3,340,26,-314
1,0,2,1,5,26,40,14
1,0,2,0,5,53,82,29
1,0,2,0,5,42,79,37
3,1,3,1,3,108,77,-31
3,0,0,1,3,69,104,35
3,0,0,0,3,193,87,-106
2,0,3,0,3,108,55,-53
3,0,0,0,3,268,58,-210
3,0,2,0,5,123,102,-21
3,1,3,4,3,23,188,165
3,0,5,2,3,5,47,42
3,1,4,0,3,94,9,-85
1,0,6,4,3,4,11,7
2,0,2,1,5,14,51,37
3,0,0,1,3,68,75,7
3,0,0,0,3,52,95,43
1,0,0,0,3,63,97,34
3,1,0,4,3,49,133,84
3,0,0,4,3,4,65,61
3,0,3,0,3,61,92,31
2,0,2,0,5,58,65,7
1,0,4,1,3,31,88,57
2,0,0,0,3,103,58,-45
3,0,2,1,5,126,21,-105
2,0,3,0,3,42,75,33
3,1,1,0,3,95,44,-51
2,0,0,4,3,44,33,-11
3,0,2,1,5,27,44,17
3,1,0,0,3,593,42,-551
3,0,6,2,3,3,34,31
3,0,6,0,3,57,16,-41
3,0,4,0,3,100,121,21
1,0,2,1,5,57,7,-50
2,0,0,0,3,43,159,116
1,1,0,0,3,142,65,-77
1,0,3,0,3,159,177,18
1,0,4,0,3,250,615,365
3,0,1,1,3,15,88,73
1,0,6,0,3,22,76,54
1,0,2,1,5,30,79,49
1,0,5,2,3,86,69,-17
3,0,0,0,3,117,64,-53
3,0,2,1,5,32,95,63
1,0,0,0,3,245,77,-168
3,0,2,0,5,74,62,-12
2,0,0,6,3,24,40,16
3,0,4,1,3,50,6,-44
3,0,5,0,3,7,74,67
3,0,0,0,3,33,183,150
2,0,2,2,5,4,40,36
3,1,0,4,3,74,41,-33
2,0,0,1,3,42,47,5
3,0,2,3,5,74,25,-49
3,0,2,0,5,195,9,-186
1,0,3,1,3,85,51,-34
1,0,3,1,3,44,26,-18
1,0,5,2,3,55,17,-38
2,0,0,1,3,48,208,160
3,0,5,1,3,49,17,-32
3,1,0,0,3,68,30,-38
2,0,1,4,3,61,62,1
3,0,5,0,3,38,45,7
3,0,3,0,3,66,29,-37
3,0,2,0,5,93,81,-12
3,0,2,1,5,68,28,-40
3,1,0,0,3,63,41,-22
3,0,3,4,3,2,106,104
1,0,6,1,3,15,27,12
3,1,7,5,3,10,1,-9
1,0,3,7,5,73,72,-1
2,0,2,1,5,48,70,22
3,0,6,2,3,3,26,23
3,0,6,3,3,1,21,20
3,0,6,0,3,23,74,51
1,0,3,0,3,75,37,-38
3,0,2,2,5,199,1,-198
3,1,4,4,3,81,112,31
3,0,0,1,3,80,58,-22
1,0,5,1,3,10,84,74
1,0,3,4,3,51,81,30
3,0,6,0,3,43,60,17
1,0,5,0,3,110,36,-74
3,1,0,0,3,38,75,37
3,1,1,1,3,5,47,42
1,0,0,1,3,401,40,-361
1,0,1,0,3,187,104,-83
0,1,3,1,3,11,52,41
1,0,1,1,3,27,100,73
3,0,2,0,5,173,21,-152
3,1,0,0,3,78,83,5
1,1,0,6,3,38,69,31
1,0,0,1,3,118,30,-88
2,0,3,0,3,35,117,82
3,0,6,0,3,14,25,11
1,0,0,1,3,72,62,-10
3,1,4,0,3,32,70,38
0,1,5,0,3,94,33,-61
3,1,0,1,3,10,54,44
1,0,2,3,5,10,42,32
1,0,2,0,5,57,91,34
3,1,0,4,3,15,67,52
2,0,1,1,3,162,67,-95
3,0,5,0,3,90,70,-20
3,0,3,0,3,46,53,7
3,0,1,6,3,7,1,-6
3,0,5,0,3,46,49,3
1,1,0,1,3,86,60,-26
3,0,2,0,5,696,73,-623
3,0,6,0,3,36,50,14
1,0,6,6,3,9,16,7
2,0,0,4,3,38,136,98
3,0,6,6,3,1,21,20
1,0,0,6,3,46,64,18
3,0,6,0,3,33,82,49
3,1,3,1,3,30,37,7
1,0,0,1,3,16,78,62
3,0,4,4,3,25,7,-18
2,0,0,0,3,26,67,41
3,0,5,0,3,60,89,29
1,0,0,0,3,64,56,-8
3,0,3,7,3,49,47,-2
1,0,5,1,3,40,21,-19
1,0,1,2,3,20,42,22
3,0,5,0,3,52,128,76
3,0,3,1,3,94,104,10
3,0,6,4,3,5,14,9
3,1,0,1,3,15,64,49
1,0,0,0,3,77,81,4
3,0,0,0,3,92,88,-4
1,0,0,1,3,104,79,-25
3,1,6,1,3,33,20,-13
1,0,4,0,3,31,65,34
3,0,6,1,3,32,182,150
1,0,3,0,3,52,105,53
3,0,5,2,3,25,4,-21
3,0,5,2,3,16,21,5
1,0,2,0,5,173,93,-80
2,0,2,0,5,52,301,249
3,0,6,0,3,56,52,-4
3,0,2,0,5,98,100,2
1,0,0,0,3,210,117,-93
1,0,2,0,5,20,103,83
3,1,6,2,3,34,3,-31
1,0,2,2,5,12,21,9
3,1,4,0,3,101,98,-3
1,0,6,0,3,84,29,-55
1,0,6,0,3,26,110,84
3,0,0,1,3,57,83,26
3,1,0,0,3,129,42,-87
1,0,0,1,3,182,31,-151
2,0,0,6,3,75,59,-16
1,0,2,2,5,15,45,30
3,0,0,2,3,21,56,35
1,0,6,0,3,89,46,-43
1,0,0,4,3,6,74,68
3,1,1,0,3,60,42,-18
2,0,1,0,3,223,13,-210
3,0,2,0,5,3,46,43
3,0,6,0,3,50,41,-9
1,0,5,0,3,40,31,-9
3,0,2,0,5,70,25,-45
3,0,0,1,3,75,13,-62
2,0,0,4,3,17,64,47
3,0,0,6,3,15,33,18
1,0,0,0,3,68,41,-27
0,1,3,6,3,128,64,-64
1,0,0,0,3,72,103,31
1,0,3,4,3,24,77,53
3,0,2,0,5,111,98,-13
3,0,2,0,5,5,106,101
0,1,3,0,3,50,13,-37
1,0,5,2,3,8,47,39
3,0,1,0,3,54,4,-50
3,0,2,7,5,1,5,4
1,0,0,0,3,136,93,-43
3,0,3,0,3,41,92,51
1,0,2,1,5,38,57,19
3,1,6,1,3,7,43,36
3,0,6,0,3,71,78,7
1,0,0,0,3,80,100,20
3,1,1,0,3,88,38,-50
3,0,2,2,5,21,68,47
3,0,2,0,5,52,181,129
1,0,6,1,3,82,47,-35
2,0,0,4,3,249,185,-64
3,1,0,1,3,22,109,87
3,0,6,0,3,66,37,-29
2,0,3,1,3,56,6,-50
1,0,0,0,3,42,107,65
3,0,5,4,3,10,3,-7
1,0,2,3,5,13,8,-5
3,1,0,1,3,43,28,-15
3,1,4,6,3,11,33,22
3,1,0,0,3,41,42,1
2,0,2,1,5,13,102,89
3,0,3,0,3,137,112,-25
3,0,3,0,3,101,65,-36
1,0,2,2,5,3,60,57
1,0,2,0,5,127,25,-102
3,0,2,0,5,18,86,68
1,0,0,1,3,62,135,73
1,0,2,1,5,195,149,-46
3,0,2,1,5,1,81,80
1,0,3,0,3,339,155,-184
1,0,0,6,3,66,28,-38
3,0,2,0,5,44,304,260
3,0,5,2,3,5,30,25
3,1,1,0,3,114,100,-14
1,0,6,0,3,76,26,-50
1,0,2,0,5,35,43,8
3,1,7,5,3,4,7,3
1,0,2,0,5,68,163,95
2,0,0,0,3,47,262,215
3,0,2,0,5,46,92,46
3,0,6,0,3,79,38,-41
1,0,3,0,3,105,21,-84
3,0,6,3,3,24,6,-18
1,0,3,0,3,91,23,-68
1,0,3,0,3,115,46,-69
1,0,0,0,3,184,139,-45
1,0,0,4,3,57,18,-39
3,1,7,5,3,4,5,1
1,0,3,1,3,58,125,67
1,0,1,4,3,28,63,35
1,0,4,0,3,112,1,-111
3,1,3,0,3,23,114,91
3,1,0,1,3,36,15,-21
3,1,0,7,3,17,8,-9
3,1,0,0,3,107,68,-39
3,0,6,1,3,41,29,-12
3,0,0,1,3,117,26,-91
0,1,3,4,3,58,53,-5
3,0,6,3,3,8,63,55
3,0,2,3,5,11,8,-3
3,0,1,1,3,503,69,-434
1,0,0,4,3,31,313,282
2,0,3,0,3,306,61,-245
1,0,5,0,3,34,20,-14
1,0,3,4,3,17,191,174
3,0,0,0,3,81,136,55
3,0,2,0,5,124,138,14
0,1,3,0,3,76,26,-50
3,0,0,4,3,51,20,-31
1,0,6,0,3,26,19,-7
2,0,2,3,5,32,103,71
0,1,3,0,3,34,48,14
2,0,0,2,3,16,46,30
3,0,2,0,5,1,82,81
1,0,4,0,3,39,157,118
1,0,3,0,3,122,181,59
3,0,6,1,3,70,23,-47
3,0,2,0,5,148,237,89
3,0,4,0,3,64,80,16
3,0,6,1,3,20,25,5
1,0,5,0,3,30,36,6
1,0,0,0,3,77,191,114
3,0,3,6,3,62,244,182
1,0,3,6,3,107,60,-47
3,0,2,0,5,58,31,-27
3,1,1,6,3,22,25,3
1,0,3,0,3,99,3,-96
2,0,2,0,5,62,12,-50
1,0,2,1,5,231,148,-83
0,1,5,0,3,20,66,46
3,0,2,3,5,45,7,-38
3,0,6,0,3,456,83,-373
2,0,2,1,5,84,11,-73
1,0,0,1,3,85,67,-18
3,0,6,1,3,24,93,69
3,1,1,0,3,43,48,5
3,0,0,0,3,48,10,-38
3,0,5,1,3,57,14,-43
1,0,6,0,3,56,47,-9
1,0,5,1,3,29,3,-26
3,0,5,0,3,94,75,-19
1,0,4,4,3,50,20,-30
1,0,0,0,3,122,41,-81
3,1,0,1,3,36,74,38
3,0,6,1,3,72,21,-51
2,0,2,4,5,3,82,79
3,0,5,2,3,3,49,46
3,1,0,0,3,194,59,-135
3,0,1,4,3,7,84,77
2,0,2,1,5,38,284,246
1,0,0,0,3,170,109,-61
3,0,0,6,3,5,94,89
1,0,2,2,5,1,33,32
3,0,1,1,3,139,20,-119
1,0,5,0,3,30,71,41
3,0,3,1,3,60,20,-40
3,1,0,0,3,67,52,-15
3,0,1,0,3,59,47,-12
2,0,2,1,5,59,1,-58
1,0,2,0,5,146,4,-142
3,0,3,0,3,96,25,-71
3,1,0,4,3,62,76,14
3,0,1,1,3,32,15,-17
3,1,1,1,3,84,7,-77
3,0,6,0,3,74,174,100
3,1,0,0,3,202,106,-96
1,0,0,1,3,64,440,376
3,0,4,0,3,14,157,143
3,1,7,5,3,9,3,-6
3,1,0,1,3,98,31,-67
1,0,0,1,3,27,51,24
3,0,2,0,5,14,198,184
3,1,1,1,3,136,15,-121
3,0,4,4,3,73,41,-32
1,0,3,0,3,77,39,-38
3,1,0,0,3,66,21,-45
0,1,5,6,3,22,2,-20
3,0,2,2,5,234,140,-94
3,0,2,0,5,40,16,-24
3,1,0,0,3,86,152,66
3,1,6,2,3,35,36,1
3,0,6,1,3,15,57,42
3,0,2,2,5,51,14,-37
3,1,0,7,3,33,60,27
3,0,4,0,3,109,29,-80
3,0,1,0,3,65,33,-32
1,0,0,4,3,118,31,-87
1,0,0,0,3,31,59,28
1,0,2,0,5,105,95,-10
3,1,1,0,3,248,8,-240
3,0,3,2,3,27,59,32
3,0,2,1,5,34,54,20
3,0,1,0,3,61,124,63
3,0,2,1,5,7,55,48
3,0,2,3,5,39,86,47
3,0,6,2,3,10,24,14
1,0,0,1,3,335,91,-244
3,0,1,0,3,39,117,78
1,0,0,0,3,118,29,-89
3,0,1,6,3,34,15,-19
3,1,5,1,3,10,72,62
2,0,2,2,5,31,3,-28
3,1,1,4,3,34,10,-24
3,0,6,2,3,70,14,-56
3,0,0,6,3,66,94,28
2,0,0,1,3,127,84,-43
3,1,1,0,3,38,12,-26
3,0,5,0,3,367,45,-322
1,0,3,0,3,70,94,24
3,0,3,4,3,48,32,-16
1,0,3,0,3,37,30,-7
1,0,0,0,3,74,67,-7
3,1,6,1,3,37,8,-29
1,0,0,6,3,62,30,-32
1,0,3,0,3,94,133,39
3,0,0,0,3,136,39,-97
3,0,6,0,3,85,20,-65
2,0,2,0,5,160,55,-105
1,0,1,1,3,24,72,48
3,0,1,0,3,33,68,35
3,0,6,1,3,5,84,79
2,0,0,1,3,298,94,-204
3,0,6,2,3,27,18,-9
3,1,5,0,3,40,48,8
1,0,0,0,3,106,37,-69
0,1,3,6,3,10,6,-4
1,0,0,1,3,19,89,70
3,1,3,1,3,329,112,-217
3,0,2,1,5,18,71,53
3,0,0,0,3,90,100,10
3,0,2,0,5,29,61,32
1,0,5,1,3,39,40,1
3,0,0,1,3,22,39,17
1,0,1,0,3,88,59,-29
1,0,3,5,3,149,72,-77
3,0,2,1,5,114,86,-28
3,1,4,0,3,55,62,7
3,0,5,1,3,43,30,-13
2,0,0,4,3,72,82,10
2,0,2,0,5,78,33,-45
2,0,2,0,5,2,181,179
3,1,4,4,3,46,25,-21
2,0,0,0,3,95,199,104
3,0,6,6,3,1,5,4
1,0,0,0,3,130,126,-4
3,0,2,1,5,6,79,73
1,0,0,0,3,118,147,29
3,1,0,0,3,34,66,32
3,0,4,2,3,4,49,45
3,0,4,2,3,67,21,-46
3,0,0,1,3,38,115,77
3,0,2,1,5,10,143,133
3,0,0,0,3,29,51,22
1,0,3,4,3,70,71,1
1,0,1,1,3,80,31,-49
2,0,3,0,3,97,208,111
3,0,6,0,3,49,103,54
1,0,3,4,3,140,30,-110
1,0,4,0,3,91,69,-22
1,0,2,0,5,190,90,-100
1,0,1,1,3,10,61,51
3,0,2,2,5,475,36,-439
1,0,3,1,3,92,56,-36
3,0,2,1,5,4,46,42
1,0,0,0,3,62,65,3
2,0,1,1,3,95,53,-42
1,0,3,0,3,130,1,-129
1,0,0,0,3,96,98,2
1,0,0,0,3,111,62,-49
2,0,0,0,3,86,89,3
1,0,6,1,3,21,14,-7
2,0,0,0,3,146,68,-78
3,0,4,1,3,434,52,-382
3,0,4,6,3,98,2,-96
2,0,2,0,5,11,66,55
3,0,0,0,3,48,102,54
0,1,3,1,3,10,28,18
1,0,1,1,3,80,17,-63
1,0,1,1,3,76,47,-29
1,0,0,1,3,85,22,-63
1,0,3,7,3,2,50,48
2,0,2,0,5,43,47,4
3,0,2,1,5,79,31,-48
1,0,5,1,3,3,40,37
1,0,5,2,3,70,54,-16
1,0,1,0,3,42,122,80
3,0,6,4,3,2,6,4
3,0,1,0,3,110,149,39
1,0,0,0,3,75,74,-1
3,0,2,0,5,30,41,11
1,0,0,7,3,50,78,28
1,0,0,1,3,106,35,-71
1,0,6,3,3,6,12,6
1,0,0,0,3,82,429,347
2,0,0,0,3,216,107,-109
1,0,3,0,3,61,65,4
3,0,2,3,5,16,73,57
1,0,2,1,5,53,13,-40
3,1,6,2,3,25,21,-4
3,1,0,0,3,180,89,-91
3,0,3,1,3,74,79,5
3,0,0,0,3,69,201,132
3,1,1,0,3,59,16,-43
1,0,6,3,3,7,77,70
1,0,3,4,3,25,132,107
3,0,3,1,3,27,101,74
3,0,0,1,3,56,35,-21
3,0,1,7,3,2,11,9
3,0,6,6,3,6,16,10
3,1,3,0,3,16,104,88
3,0,2,0,5,80,88,8
1,0,1,2,3,4,30,26
3,0,2,3,5,23,9,-14
3,0,6,0,3,20,78,58
3,1,0,6,3,166,12,-154
3,1,1,0,3,72,61,-11
1,0,4,1,3,50,68,18
3,0,2,1,5,9,70,61
3,0,3,0,3,41,32,-9
3,1,0,1,3,271,49,-222
1,0,6,2,3,34,7,-27
3,0,2,0,5,58,11,-47
3,0,0,6,3,18,55,37
3,0,0,0,3,81,32,-49
3,0,0,4,3,105,34,-71
3,1,0,0,3,84,64,-20
1,0,0,1,3,39,83,44
3,0,0,0,3,56,26,-30
3,0,0,4,3,66,59,-7
3,1,4,4,3,34,16,-18
2,0,1,0,3,53,14,-39
3,0,6,0,3,45,94,49
3,0,0,1,3,111,43,-68
3,1,6,2,3,5,64,59
1,0,0,0,3,89,95,6
3,1,4,4,3,21,31,10
1,0,6,1,3,31,12,-19
1,0,4,1,3,86,14,-72
3,0,5,0,3,53,583,530
1,0,3,0,3,94,74,-20
3,1,3,1,3,27,52,25
3,1,4,4,3,48,125,77
3,0,0,2,3,116,89,-27
3,0,5,2,3,15,137,122
3,0,2,0,5,77,63,-14
3,0,6,0,3,109,111,2
3,1,4,0,3,65,20,-45
0,1,5,0,3,42,56,14
3,1,3,4,3,7,36,29
3,1,0,0,3,217,39,-178
1,0,0,0,3,38,82,44
3,0,0,0,3,87,190,103
1,0,3,1,3,55,30,-25
3,0,0,2,3,15,50,35
3,0,6,0,3,50,19,-31
3,0,2,2,5,19,9,-10
1,0,0,1,3,29,131,102
2,0,3,4,3,77,64,-13
3,1,4,0,3,95,52,-43
3,0,2,1,5,121,67,-54
3,0,2,0,5,51,106,55
3,0,6,0,3,146,98,-48
3,0,6,1,3,52,22,-30
3,0,6,4,3,52,4,-48
1,0,3,1,3,47,206,159
1,0,0,1,3,108,80,-28
3,0,3,5,3,76,45,-31
1,0,2,1,5,15,79,64
1,0,0,0,3,81,44,-37
0,1,5,1,3,31,14,-17
1,0,3,0,3,54,156,102
1,0,6,0,3,61,60,-1
1,0,5,2,3,9,12,3
1,0,3,0,3,60,25,-35
3,0,3,1,3,103,78,-25
1,0,6,0,3,35,42,7
1,0,4,0,3,51,71,20
3,1,5,6,3,14,3,-11
1,0,2,0,5,132,98,-34
3,0,5,1,3,3,44,41
3,1,0,1,3,29,62,33
1,0,6,2,3,13,6,-7
1,0,2,0,5,120,99,-21
2,0,0,1,3,37,210,173
3,0,3,0,3,10,42,32
1,0,0,0,3,74,93,19
3,0,2,0,5,107,18,-89
0,1,0,0,3,769,41,-728
0,1,3,0,3,28,58,30
1,0,0,0,3,74,95,21
3,0,0,0,3,257,112,-145
1,0,0,0,3,67,114,47
3,0,3,0,3,921,8,-913
1,0,3,1,3,74,82,8
2,0,2,0,5,2,38,36
1,0,0,7,3,117,29,-88
3,0,2,0,5,296,52,-244
3,0,4,6,3,416,54,-362
3,0,1,0,3,158,59,-99
1,0,6,4,3,16,6,-10
1,0,5,0,3,50,69,19
3,0,5,1,3,25,87,62
2,0,0,4,3,75,30,-45
3,0,3,0,3,602,108,-494
1,0,2,1,5,23,213,190
1,0,2,0,5,16,68,52
3,0,0,1,3,60,549,489
1,0,4,1,3,15,114,99
3,0,6,0,3,79,51,-28
3,0,2,1,5,2,65,63
3,0,2,0,5,71,67,-4
1,0,2,0,5,134,145,11
3,0,6,1,3,8,99,91
3,0,5,0,3,14,78,64
1,0,6,1,3,16,30,14
3,1,1,1,3,46,67,21
1,0,0,6,3,77,107,30
3,0,4,1,3,59,105,46
2,0,0,1,3,131,61,-70
1,0,6,0,3,45,16,-29
3,1,0,1,3,32,23,-9
3,0,3,0,3,50,92,42
2,0,3,0,3,102,117,15
2,0,2,0,5,84,70,-14
3,0,4,4,3,24,141,117
3,1,0,1,3,69,15,-54
1,0,4,0,3,124,153,29
1,0,6,0,3,28,21,-7
3,1,4,4,3,6,76,70
3,1,0,0,3,89,309,220
3,0,4,1,3,25,51,26
1,0,4,7,3,13,11,-2
3,0,5,0,3,77,70,-7
3,0,1,0,3,153,255,102
3,0,6,1,3,2,52,50
2,0,2,0,5,87,96,9
1,0,3,0,3,101,95,-6
1,0,3,5,3,53,160,107
1,0,2,0,5,19,43,24
2,0,2,0,5,85,112,27
1,0,4,2,3,150,92,-58
3,0,6,1,3,23,10,-13
3,0,4,1,3,43,47,4
3,0,5,1,3,16,59,43
3,0,2,1,5,94,66,-28
3,1,0,0,3,29,74,45
3,1,0,0,3,61,50,-11
3,0,3,0,3,64,39,-25
3,0,1,1,3,24,43,19
1,0,0,0,3,95,67,-28
3,0,0,4,3,57,140,83
3,0,6,1,3,52,16,-36
1,0,0,0,3,140,127,-13
3,1,0,0,3,49,112,63
1,0,2,0,5,56,15,-41
1,0,3,0,3,84,73,-11
2,0,2,1,5,131,19,-112
1,0,6,0,3,44,33,-11
1,0,6,1,3,62,24,-38
3,1,0,1,3,75,55,-20
3,1,4,1,3,26,81,55
3,0,1,4,3,18,5,-13
1,0,4,1,3,8,75,67
3,0,0,0,3,208,98,-110
3,1,0,1,3,98,14,-84
3,0,6,0,3,35,24,-11
3,0,4,0,3,126,60,-66
1,0,5,0,3,65,9,-56
3,0,6,1,3,22,62,40
1,0,3,0,3,109,46,-63
3,1,7,6,3,8,2,-6
3,0,0,0,3,51,81,30
1,0,3,6,3,49,19,-30
1,0,6,2,3,31,5,-26
1,0,0,1,3,94,10,-84
1,0,0,0,3,119,189,70
1,0,1,4,3,4,128,124
3,0,6,1,3,61,21,-40
1,0,3,1,3,74,76,2
3,0,5,0,3,43,6,-37
1,0,4,4,3,24,72,48
1,0,5,1,3,23,45,22
1,0,0,0,3,45,58,13
1,0,4,1,3,2,110,108
3,0,0,0,3,124,74,-50
3,0,2,0,5,67,48,-19
1,0,2,3,5,4,79,75
3,0,0,6,3,20,22,2
2,0,2,0,5,52,11,-41
1,1,0,4,3,11,93,82
3,1,3,0,3,20,135,115
3,1,3,4,3,40,70,30
3,0,2,0,5,164,112,-52
3,0,2,0,5,46,39,-7
3,1,1,0,3,10,56,46
1,0,4,1,3,109,48,-61
2,0,0,2,3,31,38,7
3,0,6,1,3,20,47,27
3,0,2,0,5,89,18,-71
3,1,4,1,3,87,61,-26
3,0,1,0,3,15,75,60
2,0,3,1,3,64,70,6
3,0,2,0,5,84,134,50
0,1,3,0,3,69,64,-5
3,1,1,1,3,20,34,14
1,0,1,0,3,27,118,91
2,0,2,0,5,59,30,-29
2,0,2,2,5,19,478,459
1,0,0,0,3,97,151,54
3,0,2,0,5,200,40,-160
2,0,2,1,5,147,76,-71
1,0,2,0,5,604,14,-590
3,0,0,0,3,43,33,-10
3,0,6,1,3,25,52,27
3,1,6,1,3,14,80,66
1,0,6,4,3,11,20,9
3,0,2,1,5,85,28,-57
3,0,6,1,3,9,83,74
3,0,0,7,3,1,5,4
0,1,3,0,3,81,59,-22
1,0,5,1,3,69,100,31
1,0,0,0,3,52,87,35
3,1,4,1,3,61,13,-48
3,0,5,3,3,21,5,-16
1,0,2,4,5,80,3,-77
3,0,3,6,3,32,5,-27
1,0,3,1,3,289,132,-157
1,0,0,1,3,115,71,-44
3,0,0,4,3,132,35,-97
3,0,0,0,3,219,154,-65
3,1,4,4,3,230,52,-178
1,0,2,1,5,50,15,-35
3,1,0,1,3,209,103,-106
3,0,2,3,5,3,14,11
0,1,5,6,3,63,71,8
3,0,3,0,3,95,56,-39
1,0,3,0,3,73,93,20
1,0,5,1,3,6,38,32
3,0,2,0,5,31,46,15
3,0,0,0,3,56,497,441
3,0,3,4,3,63,7,-56
1,0,3,5,3,144,42,-102
3,1,0,4,3,32,35,3
3,1,0,0,3,121,64,-57
2,0,2,0,5,81,116,35
2,0,2,2,5,172,25,-147
1,0,6,0,3,34,87,53
1,0,5,2,3,17,1,-16
1,0,1,2,3,6,66,60
3,0,6,1,3,14,47,33
1,0,3,7,3,50,30,-20
3,0,6,0,3,114,121,7
3,1,5,0,3,36,26,-10
1,0,4,1,3,178,67,-111
3,0,2,3,5,17,29,12
3,0,6,0,3,23,718,695
3,0,1,1,3,45,124,79
3,0,2,1,5,98,33,-65
3,0,5,0,3,75,198,123
2,0,2,0,5,41,179,138
3,0,0,0,3,109,74,-35
3,1,1,1,3,63,284,221
3,0,5,0,3,2,38,36
3,0,1,0,3,87,60,-27
2,0,3,0,3,17,103,86
1,0,0,1,3,38,119,81
3,0,4,2,3,72,130,58
1,0,0,1,3,29,60,31
3,0,2,1,5,81,37,-44
3,0,6,6,3,47,4,-43
3,1,5,1,3,52,4,-48
3,1,0,1,3,21,78,57
3,1,6,1,3,3,39,36
3,0,4,1,3,103,39,-64
3,1,1,1,3,72,50,-22
3,0,4,1,3,19,543,524
2,0,2,2,5,26,170,144
3,0,5,0,3,882,64,-818
3,1,1,1,3,28,54,26
3,0,0,0,3,64,49,-15
2,0,0,0,3,244,94,-150
3,1,0,1,3,22,77,55
3,0,2,1,5,2,56,54
3,0,4,0,3,9,43,34
3,0,1,0,3,63,1,-62
3,0,3,0,3,120,35,-85
3,0,5,0,3,61,36,-25
2,0,3,0,3,86,201,115
1,0,3,1,3,5,50,45
3,1,0,0,3,102,109,7
1,0,3,0,3,43,242,199
3,1,0,4,3,28,24,-4
3,0,5,1,3,27,51,24
2,0,2,0,5,37,131,94
3,0,5,0,3,65,60,-5
3,1,1,1,3,9,126,117
1,0,2,0,5,136,73,-63
3,0,2,2,5,1,71,70
3,1,4,1,3,163,32,-131
3,0,6,0,3,46,47,1
2,0,2,0,5,28,89,61
3,0,3,7,3,16,83,67
3,1,1,0,3,101,96,-5
1,0,3,4,3,51,41,-10
3,1,0,0,3,162,91,-71
1,0,0,1,3,55,82,27
1,0,0,0,3,117,215,98
1,0,0,1,3,12,93,81
1,0,4,1,3,85,54,-31
3,0,3,0,3,137,68,-69
3,1,0,0,3,38,121,83
2,0,2,1,5,140,19,-121
1,0,0,0,3,69,79,10
3,0,3,1,3,71,14,-57
3,0,2,6,5,3,2,-1
3,1,1,4,3,32,13,-19
1,0,0,4,3,28,43,15
2,0,3,1,3,90,29,-61
2,0,3,1,3,11,163,152
1,0,0,1,3,45,7,-38
3,0,5,0,3,52,45,-7
1,0,0,4,3,33,82,49
3,1,7,6,3,1,8,7
3,0,4,6,3,3,109,106
3,1,6,1,3,28,10,-18
3,0,2,0,5,40,117,77
1,0,0,4,3,140,42,-98
3,1,7,5,3,1,7,6
3,0,3,5,3,100,89,-11
3,1,0,1,3,36,92,56
3,1,0,1,3,31,108,77
1,0,5,0,3,29,105,76
3,0,6,2,3,21,6,-15
2,0,2,0,5,41,6,-35
1,0,6,4,3,6,3,-3
3,0,0,0,3,446,145,-301
3,0,5,0,3,48,84,36
1,0,0,0,3,40,38,-2
3,1,0,1,3,232,63,-169
3,0,5,2,3,40,47,7
3,0,1,6,3,11,6,-5
1,0,6,0,3,11,55,44
1,0,5,0,3,75,47,-28
1,0,4,0,3,140,16,-124
3,0,2,0,5,15,101,86
1,0,3,0,3,65,184,119
3,0,2,1,5,6,48,42
3,0,2,0,5,40,134,94
2,0,3,1,3,74,102,28
1,0,1,0,3,471,45,-426
1,0,6,1,3,32,38,6
3,0,6,1,3,79,6,-73
3,0,2,0,5,74,3,-71
1,0,3,1,3,163,39,-124
3,0,6,0,3,15,207,192
3,0,2,2,5,69,121,52
1,0,0,0,3,198,80,-118
3,0,1,0,3,81,111,30
3,0,6,6,3,1,7,6
2,0,0,4,3,94,10,-84
1,0,3,7,3,2,172,170
1,0,1,7,3,7,46,39
1,0,2,1,5,34,82,48
1,0,0,0,3,126,154,28
1,0,0,7,3,5,40,35
3,1,0,0,3,170,66,-104
2,0,2,1,5,112,54,-58
1,0,6,0,3,55,28,-27
3,1,3,0,3,31,89,58
3,0,1,1,3,36,75,39
2,0,3,4,3,38,28,-10
3,1,4,1,3,27,11,-16
2,0,3,1,3,90,149,59
2,0,3,7,3,49,39,-10
1,0,0,0,3,53,360,307
3,0,0,1,3,66,91,25
3,0,6,1,3,42,5,-37
1,0,3,0,3,14,105,91
1,0,2,0,5,182,137,-45
2,0,3,0,3,265,196,-69
3,0,3,0,3,99,113,14
3,0,2,1,5,30,155,125
3,0,0,0,3,265,142,-123
3,1,1,0,3,59,31,-28
3,0,2,1,5,20,99,79
3,1,4,0,3,29,13,-16
3,1,6,1,3,38,1,-37
3,1,3,1,3,557,123,-434
1,0,3,0,3,153,263,110
3,1,1,0,3,12,138,126
2,0,2,0,5,77,130,53
1,0,0,1,3,55,92,37
1,0,0,1,3,77,39,-38
3,1,0,7,3,13,22,9
3,0,0,2,3,54,82,28
3,0,6,0,3,84,380,296
3,0,6,0,3,94,135,41
1,0,1,0,3,4,45,41
1,0,0,0,3,7,64,57
1,0,0,1,3,206,52,-154
3,0,0,4,3,51,9,-42
3,0,3,0,3,83,63,-20
3,0,2,0,5,70,99,29
3,1,4,0,3,58,171,113
0,1,3,7,3,43,81,38
1,0,0,0,3,260,29,-231
2,0,1,1,3,54,20,-34
3,0,4,1,3,83,109,26
3,0,0,1,3,34,93,59
3,1,6,0,3,44,76,32
2,0,0,0,3,47,83,36
3,0,5,1,3,16,26,10
3,1,4,1,3,61,127,66
1,0,2,0,5,43,175,132
1,0,3,1,3,85,340,255
2,0,3,1,3,35,119,84
3,1,3,0,3,38,131,93
3,0,3,0,3,73,89,16
1,0,6,0,3,47,32,-15
3,0,3,1,3,162,87,-75
3,0,0,0,3,25,149,124
1,0,5,4,3,39,14,-25
3,0,3,5,3,63,363,300
3,0,3,0,3,241,13,-228
0,1,3,1,3,5,123,118
3,0,2,2,5,19,42,23
2,0,2,0,5,15,148,133
1,0,5,0,3,67,58,-9
3,0,2,6,5,18,24,6
3,1,0,0,3,121,166,45
3,0,2,0,5,125,17,-108
1,0,3,4,3,4,75,71
1,0,6,1,3,42,12,-30
3,0,4,2,3,22,104,82
2,0,0,0,3,237,75,-162
3,0,6,0,3,159,42,-117
3,0,0,2,3,188,52,-136
2,0,1,1,3,76,24,-52
0,1,5,0,3,58,52,-6
3,0,2,2,5,10,22,12
3,1,5,2,3,3,18,15
2,0,2,1,5,33,14,-19
1,0,2,4,5,18,45,27
1,0,5,1,3,87,4,-83
0,1,3,1,3,67,41,-26
1,0,3,4,3,70,53,-17
3,0,3,0,3,87,73,-14
3,0,3,1,3,54,10,-44
1,0,3,6,3,48,56,8
3,0,5,0,3,79,160,81
3,1,0,4,3,33,86,53
1,0,0,0,3,90,223,133
1,0,0,0,3,67,36,-31
1,0,4,0,3,62,95,33
3,1,0,0,3,230,170,-60
0,1,5,1,3,4,51,47
3,1,0,0,3,279,195,-84
2,0,2,0,5,89,6,-83
3,0,3,1,3,18,40,22
3,0,0,4,3,46,26,-20
3,1,3,1,3,34,259,225
3,0,1,1,3,54,35,-19
3,1,0,7,3,73,10,-63
3,0,5,1,3,24,89,65
1,0,3,4,3,127,101,-26
3,0,0,4,3,10,51,41
3,0,5,1,3,24,16,-8
1,0,0,0,3,31,86,55
3,0,3,4,3,13,143,130
3,0,2,1,5,11,81,70
3,0,0,4,3,87,28,-59
3,1,1,0,3,60,8,-52
1,0,0,0,3,205,310,105
3,1,5,4,3,8,52,44
2,0,3,1,3,55,271,216
1,0,5,1,3,17,45,28
2,0,0,1,3,84,46,-38
3,0,1,0,3,104,39,-65
3,0,3,0,3,714,199,-515
3,0,0,0,3,7,77,70
3,0,3,1,3,8,48,40
3,1,1,1,3,14,258,244
3,0,2,2,5,102,15,-87
3,0,0,4,3,55,224,169
1,0,6,0,3,28,84,56
1,0,2,4,5,3,8,5
3,0,6,1,3,52,6,-46
1,0,6,2,3,8,47,39
1,0,3,0,3,48,58,10
3,0,3,4,3,20,96,76
1,0,0,0,3,182,35,-147
3,1,4,4,3,5,64,59
3,0,3,1,3,69,28,-41
3,0,0,6,3,5,99,94
2,0,2,0,5,213,221,8
3,1,1,1,3,7,61,54
2,0,3,2,3,106,12,-94
3,1,3,1,3,26,94,68
2,0,3,4,3,67,10,-57
3,0,6,0,3,66,73,7
1,0,2,1,5,4,46,42
3,1,0,0,3,21,263,242
3,0,6,1,3,46,19,-27
3,0,6,0,3,11,36,25
3,0,2,1,5,23,108,85
3,0,2,2,5,94,97,3
1,0,3,0,3,128,90,-38
2,0,3,0,3,17,67,50
1,0,6,0,3,60,47,-13
3,1,0,1,3,1147,13,-1134
3,1,5,0,3,52,37,-15
1,0,2,1,5,2,116,114
3,0,2,2,5,24,39,15
1,0,3,0,3,35,110,75
3,0,1,1,3,150,37,-113
2,0,3,6,3,96,124,28
1,0,3,4,3,25,90,65
3,0,2,1,5,6,45,39
1,0,3,1,3,129,45,-84
3,1,0,0,3,61,53,-8
1,0,4,1,3,280,11,-269
1,0,0,0,3,347,70,-277
1,0,1,1,3,25,45,20
3,0,5,1,3,55,27,-28
1,0,5,4,3,6,23,17
3,0,3,0,3,95,87,-8
3,0,0,0,3,60,505,445
3,0,5,1,3,19,9,-10
2,0,2,0,5,157,44,-113
3,0,0,1,3,33,61,28
1,0,1,0,3,169,127,-42
3,0,6,1,3,2,53,51
2,0,3,0,3,65,100,35
3,0,3,1,3,129,24,-105
3,0,6,1,3,47,52,5
3,0,3,1,3,18,56,38
3,0,0,2,3,56,90,34
3,0,4,0,3,48,34,-14
3,1,5,2,3,10,18,8
2,0,0,0,3,166,360,194
3,0,0,1,3,71,27,-44
3,0,6,1,3,74,35,-39
3,0,2,0,5,143,37,-106
1,0,3,6,3,32,57,25
1,0,0,0,3,132,51,-81
3,1,0,0,3,829,44,-785
3,0,6,1,3,100,26,-74
1,0,3,1,3,46,71,25
1,0,2,1,5,34,132,98
3,1,0,0,3,185,123,-62
3,1,4,1,3,124,50,-74
2,0,2,0,5,71,20,-51
2,0,2,1,5,76,73,-3
1,0,0,0,3,130,70,-60
1,0,0,0,3,653,72,-581
3,0,0,1,3,121,23,-98
3,0,2,0,5,132,255,123
1,0,5,1,3,10,113,103
2,0,0,0,3,217,254,37
3,1,3,0,3,62,43,-19
1,0,6,0,3,167,37,-130
1,0,5,0,3,38,482,444
1,0,0,0,3,195,95,-100
1,0,3,0,3,60,319,259
1,0,1,4,3,11,25,14
3,1,0,0,3,20,89,69
3,0,4,2,3,35,21,-14
3,0,5,0,3,53,72,19
3,0,6,0,3,64,132,68
1,0,3,0,3,2,99,97
3,0,3,1,3,40,33,-7
1,0,2,1,5,45,40,-5
2,0,0,1,3,208,12,-196
3,0,2,1,5,74,8,-66
3,0,0,0,3,46,57,11
1,0,2,1,5,46,5,-41
3,0,2,0,5,54,99,45
3,0,6,0,3,97,273,176
3,0,4,1,3,59,189,130
2,0,2,0,5,118,92,-26
1,0,2,0,5,9,58,49
3,0,3,1,3,34,69,35
3,1,4,0,3,27,130,103
1,0,5,0,3,51,5,-46
1,0,5,2,3,3,26,23
2,0,2,0,5,77,97,20
1,0,3,0,3,76,128,52
3,0,6,0,3,149,48,-101
1,0,5,0,3,3,46,43
3,0,2,0,5,89,82,-7
2,0,0,1,3,190,129,-61
3,0,2,2,5,6,79,73
3,0,6,0,3,45,117,72
0,1,3,0,3,52,18,-34
3,0,3,1,3,43,59,16
0,1,3,4,3,56,58,2
1,0,1,0,3,54,80,26
3,0,6,1,3,11,52,41
2,0,1,0,3,72,1,-71
1,0,2,0,5,86,44,-42
1,0,6,1,3,17,33,16
3,0,6,4,3,4,10,6
1,0,2,6,5,2,5,3
3,0,6,3,3,5,15,10
1,0,5,0,3,27,4,-23
3,1,0,0,3,86,55,-31
3,1,0,1,3,67,11,-56
3,1,4,1,3,70,101,31
2,0,3,0,3,132,5,-127
3,0,0,4,3,89,198,109
1,0,0,4,3,105,29,-76
3,1,1,1,3,19,11,-8
1,0,6,2,3,14,5,-9
1,0,3,0,3,66,81,15
1,0,2,0,5,105,13,-92
1,0,0,1,3,112,26,-86
3,1,3,1,3,119,36,-83
2,0,0,0,3,359,32,-327
1,0,0,0,3,37,547,510
3,0,2,3,5,14,53,39
1,0,1,1,3,19,119,100
1,0,2,7,5,5,3,-2
3,0,6,2,3,22,1,-21
3,1,4,7,3,13,3,-10
0,1,3,0,3,91,24,-67
2,0,0,6,3,10,16,6
3,0,2,1,5,177,18,-159
1,0,2,1,5,117,38,-79
1,0,3,1,3,68,153,85
0,1,4,0,3,5,55,50
3,1,1,1,3,81,6,-75
3,0,2,0,5,70,81,11
1,0,2,0,5,44,42,-2
3,1,6,1,3,29,14,-15
3,0,3,0,3,105,109,4
1,0,4,0,3,1473,93,-1380
1,0,3,1,3,19,53,34
3,0,1,1,3,19,18,-1
3,0,4,0,3,48,153,105
1,0,3,0,3,90,140,50
3,1,3,6,3,19,52,33
1,0,0,0,3,182,196,14
3,0,5,1,3,5,265,260
1,0,3,1,3,126,21,-105
3,1,0,0,3,164,69,-95
1,0,0,0,3,122,57,-65
3,0,5,2,3,84,64,-20
1,0,0,0,3,70,77,7
3,0,1,1,3,175,89,-86
3,0,2,1,5,141,40,-101
3,0,4,4,3,21,40,19
3,1,6,2,3,3,20,17
1,0,0,0,3,103,60,-43
1,0,0,0,3,149,369,220
3,0,1,0,3,10,133,123
3,1,3,6,3,3,27,24
3,1,0,1,3,16,33,17
1,0,4,0,3,87,91,4
3,0,6,0,3,51,62,11
3,0,0,1,3,25,43,18
0,1,3,6,3,46,58,12
1,1,0,0,3,68,66,-2
3,0,3,1,3,10,390,380
3,0,5,4,3,2,9,7
1,0,6,1,3,10,80,70
3,0,4,1,3,90,108,18
1,0,3,6,3,20,36,16
1,0,6,0,3,81,79,-2
1,0,5,2,3,22,3,-19
3,0,5,0,3,71,56,-15
3,1,0,4,3,72,103,31
3,1,0,1,3,287,87,-200
3,0,3,6,3,211,50,-161
3,1,6,0,3,20,24,4
1,0,6,2,3,39,3,-36
3,1,3,1,3,41,30,-11
3,0,2,1,5,47,17,-30
3,0,0,0,3,93,2,-91
3,0,2,6,5,36,10,-26
1,0,0,0,3,101,69,-32
1,0,2,2,5,1,66,65
3,0,2,2,5,29,4,-25
1,0,0,4,3,70,62,-8
3,0,6,7,3,9,2,-7
3,0,0,7,3,22,21,-1
2,0,2,0,5,49,116,67
2,0,0,1,3,169,61,-108
3,0,6,6,3,12,31,19
3,1,5,0,3,30,52,22
2,0,0,1,3,146,41,-105
3,1,5,4,3,21,18,-3
3,0,1,1,3,30,8,-22
0,1,5,1,3,14,28,14
3,0,6,0,3,62,142,80
3,0,3,0,3,132,42,-90
3,0,6,0,3,135,434,299
3,0,6,2,3,7,15,8
3,0,2,6,5,6,1,-5
1,0,2,2,5,47,16,-31
2,0,0,7,3,69,4,-65
3,1,0,0,3,92,50,-42
2,0,2,2,5,64,9,-55
3,0,3,1,3,75,60,-15
2,0,0,0,3,52,67,15
1,0,3,6,3,68,54,-14
3,1,0,1,3,32,97,65
3,0,6,1,3,48,10,-38
1,0,0,0,3,122,378,256
3,0,0,0,3,330,51,-279
1,0,3,0,3,13,39,26
2,0,0,4,3,32,97,65
3,0,6,3,3,14,7,-7
1,0,6,1,3,21,4,-17
3,0,3,2,3,14,115,101
3,0,6,0,3,38,57,19
3,0,5,1,3,30,102,72
1,0,0,0,3,95,427,332
2,0,3,1,3,32,21,-11
1,0,0,7,3,21,22,1
3,0,0,0,3,90,54,-36
2,0,2,1,5,49,105,56
3,0,2,2,5,67,110,43
3,0,3,1,3,134,11,-123
3,0,6,2,3,2,28,26
3,0,5,0,3,122,49,-73
3,0,2,1,5,20,92,72
1,0,3,1,3,5,343,338
1,0,3,0,3,397,20,-377
1,0,4,1,3,38,70,32
3,1,0,0,3,80,125,45
3,1,1,0,3,74,8,-66
1,0,2,0,5,224,28,-196
3,0,3,0,3,75,172,97
3,1,0,0,3,101,98,-3
3,1,1,4,3,3,46,43
1,0,0,6,3,49,15,-34
3,1,3,0,3,79,45,-34
3,1,4,6,3,73,3,-70
2,0,2,0,5,24,133,109
0,1,3,0,3,36,40,4
3,0,0,1,3,285,52,-233
1,1,0,4,3,87,103,16
1,0,5,0,3,41,24,-17
3,1,0,6,3,6,119,113
1,0,2,0,5,60,70,10
3,0,2,0,5,44,29,-15
1,0,5,6,3,20,1,-19
3,0,2,2,5,20,15,-5
3,1,6,1,3,4,43,39
3,0,5,1,3,87,15,-72
1,0,5,7,5,8,9,1
1,0,3,0,3,165,145,-20
3,0,2,0,5,29,106,77
3,0,6,0,3,51,74,23
3,0,1,0,3,233,51,-182
0,1,3,0,3,92,91,-1
3,0,0,0,3,92,141,49
1,0,0,1,3,117,21,-96
1,0,0,0,3,37,45,8
2,0,2,1,5,4,120,116
3,0,3,1,3,227,84,-143
3,1,1,4,3,39,12,-27
3,1,1,0,3,6,31,25
3,0,0,0,3,78,51,-27
1,0,3,0,3,41,183,142
3,0,4,0,3,159,101,-58
1,0,0,0,3,74,114,40
3,0,0,1,3,58,112,54
3,0,2,1,5,9,73,64
1,0,2,0,5,139,17,-122
3,1,3,1,3,78,171,93
3,0,3,0,3,15,94,79
3,1,4,1,3,19,15,-4
3,1,3,0,3,90,58,-32
3,0,1,0,3,6,16,10
1,0,6,0,3,81,149,68
3,0,0,4,3,80,19,-61
1,0,3,6,3,9,19,10
3,0,0,6,3,72,109,37
3,0,0,1,3,40,4,-36
1,0,6,0,3,16,694,678
3,1,1,0,3,29,24,-5
3,0,0,6,3,61,13,-48
2,0,2,2,5,27,130,103
1,0,2,0,5,11,60,49
3,0,4,6,3,1,52,51
3,0,0,0,3,116,79,-37
1,0,0,0,3,114,67,-47
1,0,0,0,3,653,54,-599
3,0,2,0,5,52,256,204
3,0,0,4,3,21,26,5
1,0,3,1,3,110,71,-39
1,0,0,1,3,139,28,-111
3,0,3,0,3,957,28,-929
0,1,5,0,3,84,35,-49
3,1,0,0,3,87,251,164
1,0,2,0,5,76,77,1
3,0,2,0,5,56,264,208
1,0,1,4,3,100,70,-30
3,0,0,0,3,47,52,5
3,0,0,0,3,58,36,-22
1,0,3,0,3,4,104,100
1,0,4,0,3,83,77,-6
1,0,2,2,5,79,4,-75
2,0,0,1,3,83,95,12
3,1,1,0,3,51,148,97
3,1,4,1,3,6,62,56
3,0,2,0,5,10,46,36
1,0,3,0,3,150,103,-47
3,0,3,7,3,53,7,-46
2,0,2,3,5,9,105,96
1,0,6,0,3,52,98,46
3,0,5,0,3,33,24,-9
1,0,2,1,5,10,103,93
3,0,2,0,5,129,74,-55
1,0,5,0,3,32,138,106
1,0,5,2,3,21,53,32
1,0,2,1,5,17,45,28
2,0,2,0,5,10,70,60
2,0,0,0,3,55,45,-10
3,0,2,1,5,107,65,-42
3,0,1,1,3,27,43,16
1,0,0,1,3,104,23,-81
0,1,5,0,3,19,24,5
3,0,5,0,3,643,49,-594
1,0,6,1,3,85,25,-60
3,0,5,0,3,44,26,-18
3,0,2,0,5,39,149,110
3,0,6,0,3,17,69,52
1,0,3,0,3,103,50,-53
3,0,2,3,5,46,24,-22
3,1,0,0,3,152,166,14
3,0,5,0,3,103,25,-78
1,0,4,0,3,111,82,-29
3,1,0,1,3,11,532,521
2,0,0,4,3,74,102,28
3,0,1,1,3,78,23,-55
3,1,0,0,3,13,95,82
3,0,5,0,3,54,46,-8
1,0,3,1,3,158,41,-117
3,0,0,1,3,70,36,-34
1,0,5,0,3,32,6,-26
1,0,2,0,5,3,74,71
1,0,4,1,3,7,105,98
2,0,3,4,3,111,39,-72
3,0,2,1,5,34,30,-4
0,1,3,1,3,66,98,32
3,0,5,4,3,10,33,23
0,1,3,0,3,7,53,46
1,0,4,0,3,214,44,-170
3,0,4,4,3,52,31,-21
3,0,0,1,3,198,230,32
1,0,1,0,3,135,78,-57
3,0,3,0,3,58,35,-23
1,0,0,0,3,32,44,12
1,0,4,0,3,133,135,2
1,0,1,2,3,2,155,153
1,0,2,0,5,13,109,96
3,0,2,0,5,186,8,-178
3,0,2,1,5,36,184,148
2,0,3,0,3,53,139,86
1,0,0,1,3,101,38,-63
1,0,3,0,3,60,21,-39
3,0,3,0,3,60,54,-6
2,0,2,0,5,178,17,-161
1,0,3,0,3,123,159,36
3,1,0,4,3,78,20,-58
3,0,5,1,3,26,48,22
1,0,0,1,3,38,67,29
1,0,0,1,3,106,179,73
3,1,3,1,3,113,40,-73
2,0,0,1,3,34,196,162
3,0,4,0,3,108,23,-85
1,0,0,1,3,211,16,-195
3,0,4,0,3,180,145,-35
3,0,5,2,3,57,26,-31
3,0,2,1,5,88,84,-4
3,0,1,4,3,10,1,-9
3,0,2,0,5,110,26,-84
2,0,0,0,3,41,52,11
3,0,6,1,3,104,19,-85
1,0,3,4,3,4,47,43
3,0,5,0,3,90,265,175
2,0,0,0,3,258,69,-189
3,0,4,0,3,98,151,53
3,1,0,4,3,24,7,-17
1,0,6,4,3,11,18,7
1,0,5,0,3,93,59,-34
3,1,4,1,3,69,25,-44
3,0,6,1,3,28,5,-23
0,1,3,1,3,205,65,-140
1,0,1,0,3,827,54,-773
1,0,0,1,3,22,85,63
3,0,0,6,3,123,50,-73
3,0,2,2,5,19,34,15
3,1,0,0,3,88,111,23
2,0,3,1,3,15,76,61
3,0,1,4,3,53,12,-41
1,0,3,1,3,92,17,-75
3,0,0,4,3,62,19,-43
1,0,0,0,3,87,109,22
2,0,0,0,3,75,92,17
1,0,2,0,5,69,8,-61
1,0,4,1,3,92,56,-36
3,0,2,6,5,2,38,36
1,0,6,0,3,56,90,34
1,0,0,1,3,186,18,-168
1,0,3,1,3,29,79,50
3,0,1,1,3,41,3,-38
3,0,5,0,3,70,542,472
3,1,3,1,3,1,76,75
2,0,0,0,3,106,74,-32
2,0,2,1,5,39,6,-33
3,0,4,1,3,57,29,-28
3,0,0,1,3,47,107,60
2,0,1,1,3,79,40,-39
1,0,3,1,3,86,48,-38
1,0,2,0,5,10,89,79
3,0,6,0,3,28,44,16
3,1,3,0,3,6,84,78
1,0,4,2,3,2,73,71
1,0,2,1,5,73,3,-70
1,0,4,2,3,54,184,130
3,0,0,4,3,72,94,22
1,0,4,2,3,50,47,-3
1,0,5,1,3,9,53,44
1,0,3,6,3,28,110,82
2,0,0,0,3,67,64,-3
1,0,1,1,3,38,194,156
3,0,2,3,5,4,15,11
2,0,2,3,5,6,20,14
2,0,1,0,3,63,74,11
3,1,0,6,3,14,16,2
1,0,3,4,3,14,60,46
3,0,3,6,3,20,31,11
1,0,3,0,3,65,25,-40
3,0,6,0,3,71,114,43
1,0,2,0,5,128,52,-76
2,0,2,0,5,66,87,21
3,1,6,0,3,37,40,3
0,1,3,0,3,5,60,55
3,0,2,2,5,16,33,17
1,0,4,0,3,71,57,-14
3,0,0,0,3,624,347,-277
3,0,6,1,3,12,27,15
3,1,4,0,3,7,114,107
3,1,3,4,3,83,33,-50
3,1,0,0,3,17,69,52
2,0,3,4,3,118,66,-52
3,0,0,1,3,54,84,30
3,0,3,1,3,21,62,41
1,0,0,1,3,60,66,6
3,0,2,7,5,6,1,-5
1,1,0,6,3,113,72,-41
1,0,0,0,3,102,45,-57
3,0,6,1,3,26,23,-3
3,0,5,1,3,32,5,-27
1,0,3,0,3,40,110,70
3,0,6,1,3,16,65,49
3,1,6,0,3,41,28,-13
1,0,0,4,3,57,159,102
3,1,0,0,3,122,33,-89
3,0,2,1,5,200,17,-183
1,0,4,2,3,31,17,-14
3,0,0,1,3,70,35,-35
3,0,4,1,3,12,18,6
3,0,6,0,3,89,74,-15
3,0,1,0,3,23,1,-22
1,0,2,2,5,22,13,-9
1,0,5,1,3,52,4,-48
1,0,1,1,3,39,33,-6
0,1,5,2,3,2,21,19
3,0,3,1,3,148,23,-125
3,1,1,6,3,13,11,-2
3,0,1,0,3,7,61,54
1,0,0,0,3,118,105,-13
1,0,3,0,3,91,247,156
2,0,3,0,3,44,126,82
3,0,0,0,3,162,106,-56
3,1,4,1,3,27,37,10
3,0,5,1,3,2,22,20
1,0,2,4,5,7,2,-5
2,0,2,0,5,148,14,-134
1,0,3,6,3,75,20,-55
3,0,0,0,3,118,329,211
3,0,4,1,3,10,255,245
1,0,3,1,3,74,121,47
3,1,3,1,3,45,30,-15
1,0,2,0,5,3,183,180
3,1,0,4,3,61,31,-30
3,0,6,0,3,77,166,89
1,0,1,0,3,40,42,2
0,1,5,1,3,58,14,-44
3,0,0,0,3,158,39,-119
3,0,2,0,5,155,64,-91
1,0,2,0,5,93,32,-61
2,0,2,0,5,38,16,-22
1,0,0,1,3,133,48,-85
3,0,5,0,3,73,66,-7
1,0,0,1,3,72,81,9
1,0,0,0,3,106,54,-52
3,0,1,4,3,25,16,-9
1,0,1,7,3,19,11,-8
3,0,6,0,3,96,43,-53
1,0,6,0,3,47,15,-32
2,0,0,0,3,40,92,52
1,0,1,6,3,13,3,-10
1,0,5,0,3,12,47,35
1,0,0,4,3,150,87,-63
3,0,1,0,3,97,145,48
1,0,1,6,3,84,5,-79
1,0,0,0,3,88,111,23
3,1,1,1,3,47,15,-32
3,0,0,1,3,31,171,140
3,1,1,1,3,10,19,9
3,1,0,4,3,128,16,-112
1,0,3,0,3,19,145,126
2,0,2,2,5,67,2,-65
3,1,1,0,3,39,14,-25
3,1,1,0,3,102,99,-3
3,1,1,0,3,50,130,80
1,0,0,0,3,148,93,-55
1,0,2,3,5,17,4,-13
3,0,6,1,3,9,21,12
1,0,0,6,3,21,72,51
0,1,3,0,3,7,124,117
3,0,1,0,3,73,31,-42
3,0,1,6,3,5,4,-1
3,0,2,0,5,112,20,-92
3,0,0,1,3,48,32,-16
1,0,6,1,3,84,26,-58
3,0,6,1,3,45,10,-35
1,0,3,0,3,8,159,151
1,0,3,0,3,88,124,36
3,0,5,0,3,50,81,31
2,0,2,0,5,86,71,-15
1,0,0,1,3,29,101,72
3,0,3,0,3,74,17,-57
1,0,5,0,3,9,75,66
3,0,5,2,3,34,43,9
3,0,0,1,3,81,104,23
3,0,2,0,5,52,89,37
3,0,2,0,5,60,64,4
3,0,1,0,3,115,113,-2
3,0,2,1,5,1,120,119
3,1,1,1,3,72,27,-45
1,0,1,2,3,44,7,-37
3,1,0,4,3,58,81,23
1,0,3,6,3,104,1,-103
2,0,2,0,5,35,118,83
1,0,5,1,3,111,41,-70
3,1,3,0,3,396,96,-300
1,0,0,1,3,173,71,-102
2,0,2,0,5,77,340,263
1,0,5,4,3,6,17,11
3,0,3,0,3,47,86,39
3,1,7,5,3,8,3,-5
3,0,0,1,3,20,89,69
3,0,6,0,3,50,96,46
1,0,2,0,5,142,18,-124
1,0,0,1,3,26,64,38
3,0,5,6,3,41,8,-33
0,1,3,1,3,182,83,-99
3,0,6,1,3,7,143,136
1,0,5,0,3,43,5,-38
1,0,5,1,3,64,6,-58
1,0,0,6,3,80,104,24
1,0,3,1,3,121,78,-43
3,0,6,4,3,40,6,-34
3,0,0,1,3,48,68,20
3,1,0,1,3,40,42,2
3,0,2,1,5,37,31,-6
3,0,2,0,5,39,182,143
2,0,0,0,3,37,911,874
3,1,5,6,3,8,2,-6
3,0,5,0,3,63,43,-20
2,0,3,1,3,64,2,-62
3,0,5,2,3,44,68,24
2,0,0,0,3,109,53,-56
1,0,2,1,5,34,31,-3
3,0,2,1,5,30,4,-26
1,0,4,6,3,8,3,-5
3,0,0,1,3,49,106,57
1,0,1,0,3,224,70,-154
1,0,1,0,3,40,17,-23
1,0,6,0,3,26,38,12
3,0,2,3,5,15,2,-13
1,0,3,1,3,7,28,21
1,0,2,0,5,46,147,101
2,0,3,1,3,167,110,-57
2,0,2,0,5,37,24,-13
2,0,3,0,3,38,77,39
2,0,3,0,3,199,131,-68
1,0,0,0,3,61,76,15
3,0,2,1,5,45,28,-17
3,0,3,1,3,212,118,-94
3,1,1,1,3,23,92,69
2,0,2,1,5,113,44,-69
1,0,2,0,5,146,99,-47
3,0,0,0,3,56,45,-11
1,0,6,1,3,100,19,-81
3,1,1,1,3,73,13,-60
3,0,1,6,3,38,25,-13
2,0,2,1,5,72,77,5
3,0,4,0,3,3,45,42
0,1,3,6,3,35,7,-28
1,0,3,4,3,20,26,6
2,0,0,6,3,16,9,-7
3,0,0,4,3,12,52,40
3,0,6,1,3,159,13,-146
3,1,3,6,3,35,22,-13
3,1,0,0,3,280,87,-193
1,0,2,0,5,180,10,-170
3,0,6,0,3,44,16,-28
1,0,0,0,3,108,49,-59
3,1,3,0,3,103,70,-33
1,0,5,0,3,35,4,-31
2,0,3,0,3,135,39,-96
3,0,5,0,3,10,108,98
3,1,0,1,3,27,72,45
1,0,5,2,3,7,13,6
1,0,4,0,3,79,138,59
3,0,4,4,3,109,45,-64
1,0,1,1,3,82,73,-9
3,0,6,0,3,38,65,27
3,0,0,1,3,13,65,52
3,1,0,0,3,75,55,-20
1,0,0,0,3,70,59,-11
2,0,0,1,3,11,38,27
3,0,0,0,3,100,42,-58
1,0,0,1,3,69,18,-51
2,0,1,4,3,36,16,-20
3,0,0,6,3,163,137,-26
3,0,0,1,3,104,18,-86
2,0,2,0,5,45,187,142
3,0,3,0,3,32,99,67
3,0,6,0,3,20,13,-7
3,0,0,0,3,59,95,36
3,0,0,0,3,167,42,-125
2,0,2,0,5,50,15,-35
1,0,2,0,5,92,50,-42
1,0,0,6,3,559,112,-447
3,0,0,1,3,117,54,-63
2,0,0,0,3,51,37,-14
3,0,3,4,3,92,17,-75
3,1,1,1,3,7,34,27
3,0,2,0,5,13,45,32
2,0,2,0,5,198,28,-170
1,0,0,1,3,129,21,-108
3,0,0,1,3,121,64,-57
3,1,0,0,3,151,199,48
2,0,2,1,5,171,21,-150
3,0,4,4,3,35,70,35
1,0,4,0,3,33,59,26
3,1,1,0,3,160,25,-135
3,0,2,0,5,47,2,-45
1,0,0,0,3,91,97,6
1,0,0,0,3,337,100,-237
1,0,3,1,3,52,15,-37
1,0,0,6,3,35,11,-24
2,0,1,0,3,19,66,47
1,0,5,0,3,3,133,130
2,0,0,4,3,82,63,-19
1,0,1,0,3,50,33,-17
3,0,5,1,3,9,81,72
3,0,2,0,5,56,94,38
1,0,4,0,3,98,23,-75
3,0,3,4,3,83,109,26
1,1,0,0,3,93,104,11
3,0,0,6,3,11,2,-9
3,1,5,4,3,9,2,-7
3,0,0,0,3,150,113,-37
1,0,2,2,5,22,13,-9
3,0,0,0,3,70,42,-28
3,0,5,4,3,13,114,101
3,0,3,0,3,93,131,38
3,0,1,1,3,3,145,142
3,1,0,4,3,31,44,13
3,0,0,0,3,77,108,31
1,0,4,1,3,3,167,164
2,0,2,1,5,53,44,-9
3,0,5,0,3,72,28,-44
3,0,6,3,3,51,9,-42
2,0,0,7,3,49,44,-5
1,0,3,1,3,82,40,-42
3,0,5,0,3,30,10,-20
3,1,3,1,3,149,208,59
3,0,6,1,3,39,59,20
3,1,4,6,3,70,68,-2
0,1,3,0,3,50,74,24
3,0,2,0,5,46,73,27
3,1,7,5,3,8,1,-7
3,0,6,3,3,28,16,-12
1,0,3,0,3,87,254,167
1,0,0,1,3,115,35,-80
3,1,3,1,3,22,35,13
3,1,0,1,3,259,36,-223
3,0,6,0,3,45,36,-9
1,0,6,1,3,36,21,-15
1,0,0,0,3,57,113,56
3,0,0,0,3,76,134,58
3,0,3,0,3,100,159,59
3,0,1,0,3,34,147,113
3,0,0,0,3,95,123,28
3,0,2,4,5,3,19,16
3,0,2,0,5,185,10,-175
1,0,2,0,5,48,103,55
1,0,2,0,5,32,51,19
3,0,6,1,3,46,5,-41
2,0,2,0,5,28,118,90
3,0,6,1,3,15,73,58
3,0,6,2,3,14,34,20
1,0,6,0,3,50,57,7
3,1,4,0,3,12,98,86
3,1,1,0,3,18,55,37
3,1,3,0,3,97,401,304
3,0,3,0,3,112,524,412
1,0,3,1,3,85,114,29
3,0,2,1,5,63,55,-8
2,0,3,0,3,79,98,19
1,0,4,0,3,112,116,4
0,1,3,0,3,43,53,10
3,0,0,6,3,148,9,-139
3,0,2,2,5,8,161,153
1,0,3,1,3,48,124,76
3,0,6,0,3,31,50,19
3,1,0,0,3,102,52,-50
3,0,4,2,3,23,58,35
3,1,0,0,3,111,46,-65
1,0,2,0,5,80,76,-4
3,0,2,0,5,25,68,43
3,0,6,2,3,66,1,-65
1,0,3,4,3,58,139,81
3,0,3,1,3,4,144,140
3,0,0,6,3,59,67,8
2,0,3,1,3,467,367,-100
3,0,6,1,3,6,46,40
3,0,5,0,3,64,87,23
3,0,0,1,3,240,16,-224
2,0,0,1,3,53,40,-13
2,0,3,0,3,115,55,-60
1,0,2,0,5,123,6,-117
3,1,4,0,3,56,52,-4
3,0,6,4,3,5,7,2
3,0,2,2,5,42,7,-35
1,0,3,0,3,102,87,-15
3,0,3,0,3,10,57,47
1,0,3,0,3,41,129,88
1,0,6,1,3,2,48,46
1,0,5,1,3,1,101,100
1,0,0,0,3,51,276,225
2,0,1,0,3,92,145,53
1,0,4,0,3,39,81,42
3,0,2,4,5,2,39,37
3,0,1,6,3,14,48,34
3,1,3,0,3,22,78,56
3,0,5,1,3,58,57,-1
3,0,6,0,3,59,84,25
3,1,0,1,3,309,40,-269
3,0,2,0,5,126,55,-71
3,0,0,0,3,43,50,7
3,0,6,2,3,17,12,-5
3,0,6,2,3,2,16,14
0,1,3,0,3,107,70,-37
1,0,5,0,3,206,98,-108
3,0,5,0,3,119,133,14
3,0,0,6,3,9,81,72
3,1,0,0,3,57,75,18
2,0,2,2,5,40,6,-34
3,0,2,4,5,11,15,4
3,0,3,0,3,126,98,-28
2,0,0,1,3,141,188,47
3,1,1,6,3,14,15,1
3,1,3,1,3,6,188,182
1,0,0,1,3,39,316,277
1,0,2,1,5,50,84,34
3,0,2,0,5,55,61,6
3,1,0,1,3,101,39,-62
3,0,0,1,3,62,101,39
1,0,4,2,3,77,16,-61
1,0,6,2,3,31,118,87
2,0,1,0,3,23,38,15
3,0,3,4,3,119,133,14
1,0,0,1,3,115,29,-86
3,0,2,0,5,26,132,106
3,1,0,1,3,83,21,-62
3,1,3,0,3,48,51,3
3,0,3,1,3,5,70,65
1,0,4,0,3,160,98,-62
1,0,3,7,3,43,78,35
1,0,3,0,3,95,21,-74
2,0,1,0,3,698,6,-692
2,0,3,0,3,78,64,-14
2,0,3,7,3,19,33,14
3,1,0,0,3,62,35,-27
1,0,3,0,3,396,85,-311
3,0,2,0,5,94,19,-75
3,1,1,1,3,34,57,23
1,0,3,1,3,17,227,210
3,0,0,0,3,80,406,326
1,0,0,1,3,109,119,10
3,0,0,6,3,56,37,-19
3,0,1,6,3,1,8,7
3,1,0,0,3,135,92,-43
3,0,5,0,3,16,21,5
3,0,0,1,3,77,31,-46
3,1,0,0,3,27,89,62
3,0,2,0,5,32,201,169
3,0,6,0,3,20,102,82
1,0,2,0,5,75,80,5
3,0,1,1,3,36,93,57
3,0,6,0,3,42,399,357
3,0,2,0,5,68,7,-61
3,0,6,1,3,1,62,61
3,1,6,1,3,20,55,35
3,1,0,4,3,13,113,100
3,0,3,0,3,95,6,-89
1,0,3,0,3,13,62,49
1,0,3,1,3,7,82,75
3,1,0,7,3,53,60,7
3,0,5,0,3,117,50,-67
3,0,1,0,3,111,86,-25
3,1,3,0,3,28,89,61
3,0,4,6,3,51,41,-10
1,0,6,1,3,72,3,-69
3,0,6,1,3,163,35,-128
3,0,2,0,5,87,18,-69
2,0,3,0,3,61,121,60
1,0,6,4,3,4,5,1
3,0,2,2,5,13,51,38
3,0,2,1,5,22,60,38
1,0,3,4,3,92,164,72
3,0,0,1,3,36,46,10
3,1,1,0,3,68,9,-59
3,1,0,0,3,100,60,-40
3,0,0,1,3,150,105,-45
1,0,0,1,3,129,1184,1055
3,0,2,2,5,71,12,-59
3,0,6,1,3,54,22,-32
1,0,0,0,3,91,84,-7
3,0,6,0,3,74,63,-11
3,0,0,0,3,172,164,-8
1,0,0,1,3,70,114,44
3,0,2,0,5,47,32,-15
2,0,3,1,3,229,130,-99
1,0,0,1,3,67,123,56
3,0,0,0,3,108,74,-34
3,1,4,1,3,16,39,23
3,0,2,0,5,28,69,41
3,0,5,4,3,8,3,-5
3,0,6,1,3,273,29,-244
3,0,2,2,5,93,40,-53
1,0,0,0,3,946,45,-901
3,1,0,1,3,11,53,42
1,0,0,0,3,29,357,328
3,0,3,0,3,1288,25,-1263
0,1,3,4,3,65,39,-26
3,1,1,0,3,8,30,22
2,0,3,0,3,16,88,72
3,1,1,4,3,7,18,11
3,0,0,1,3,44,65,21
1,0,2,0,5,12,90,78
1,0,6,3,3,3,24,21
1,0,0,6,3,13,48,35
3,1,5,1,3,16,11,-5
3,0,1,2,3,13,37,24
3,0,6,4,3,3,9,6
3,1,6,0,3,55,49,-6
1,0,2,0,5,303,46,-257
1,0,0,0,3,143,130,-13
3,0,1,0,3,95,118,23
3,0,0,1,3,100,21,-79
2,0,2,2,5,27,21,-6
3,0,3,0,3,16,106,90
1,0,0,0,3,79,83,4
3,0,5,0,3,12,30,18
3,0,6,0,3,181,94,-87
2,0,0,2,3,60,7,-53
3,0,5,1,3,25,84,59
1,0,0,0,3,48,585,537
3,1,0,1,3,50,34,-16
1,0,2,0,5,239,18,-221
1,0,3,0,3,75,90,15
3,0,6,2,3,17,349,332
1,0,3,1,3,661,28,-633
1,0,6,7,3,10,12,2
1,0,5,0,3,53,37,-16
1,0,6,1,3,52,10,-42
3,0,2,0,5,22,91,69
3,0,6,0,3,36,24,-12
3,0,1,0,3,173,46,-127
2,0,3,0,3,188,48,-140
3,0,5,1,3,271,2,-269
3,0,2,1,5,6,163,157
1,0,3,4,3,100,87,-13
3,0,0,1,3,9,27,18
1,0,0,0,3,41,18,-23
3,1,0,0,3,77,82,5
3,1,3,0,3,63,97,34
3,0,4,1,3,103,40,-63
1,0,0,1,3,23,257,234
1,0,1,1,3,43,37,-6
3,1,0,1,3,78,123,45
1,0,0,0,3,72,120,48
3,0,6,1,3,72,25,-47
2,0,2,0,5,110,49,-61
1,0,2,1,5,98,91,-7
1,0,3,4,3,103,96,-7
3,0,6,1,3,52,17,-35
2,0,0,6,3,24,41,17
3,0,5,0,3,7,30,23
2,0,3,0,3,108,93,-15
1,0,0,0,3,72,22,-50
2,0,0,1,3,50,64,14
1,0,6,0,3,37,67,30
3,0,0,4,3,58,78,20
3,0,6,2,3,6,23,17
1,0,6,2,3,12,6,-6
3,1,0,0,3,81,53,-28
1,0,3,0,3,78,58,-20
3,0,6,0,3,83,232,149
3,1,0,0,3,101,89,-12
3,0,6,1,3,61,8,-53
1,0,6,1,3,10,45,35
1,0,3,0,3,156,117,-39
3,1,0,0,3,73,33,-40
3,1,3,0,3,72,114,42
1,0,3,0,3,118,121,3
1,0,3,1,3,68,77,9
3,0,1,1,3,105,38,-67
3,1,3,7,3,20,46,26
0,1,3,0,3,71,4,-67
1,0,3,0,3,94,69,-25
1,0,0,0,3,61,63,2
3,0,5,1,3,52,21,-31
1,0,5,1,3,69,13,-56
1,0,2,0,5,91,173,82
1,0,5,2,3,21,1,-20
3,0,2,0,5,84,22,-62
3,0,2,1,5,121,41,-80
3,0,6,0,3,32,40,8
3,0,3,0,3,66,150,84
0,1,3,0,3,29,78,49
1,0,3,4,3,77,164,87
3,0,4,0,3,61,94,33
1,1,0,0,3,343,100,-243
1,0,5,6,3,5,26,21
3,0,5,1,3,50,26,-24
3,1,4,1,3,10,96,86
1,0,6,0,3,361,17,-344
3,0,6,4,3,3,36,33
3,0,6,1,3,86,20,-66
3,0,6,2,3,93,5,-88
3,0,2,2,5,69,1,-68
3,0,0,4,3,42,14,-28
3,0,6,1,3,7,92,85
3,0,0,0,3,89,73,-16
3,0,2,0,5,105,67,-38
1,0,1,1,3,25,64,39
1,0,6,0,3,58,57,-1
1,0,1,1,3,59,38,-21
1,0,3,0,3,68,20,-48
3,0,5,0,3,35,29,-6
1,0,2,1,5,3,44,41
1,0,0,0,3,64,34,-30
3,0,2,6,5,6,15,9
1,0,2,0,5,95,1,-94
3,0,3,0,3,56,66,10
1,0,5,1,3,50,42,-8
1,0,0,1,3,32,100,68
3,1,0,1,3,41,106,65
2,0,3,0,3,85,148,63
1,0,0,1,3,254,27,-227
2,0,0,1,3,156,110,-46
1,0,3,1,3,103,84,-19
3,0,0,1,3,31,95,64
0,1,5,1,3,77,3,-74
3,1,5,2,3,25,3,-22
3,0,0,0,3,132,97,-35
2,0,3,4,3,97,64,-33
3,0,3,0,3,6,209,203
3,0,0,0,3,28,122,94
1,0,0,1,3,86,617,531
3,1,0,0,3,524,117,-407
1,0,1,1,3,82,83,1
2,0,3,0,3,44,90,46
1,0,0,4,3,50,39,-11
1,0,0,0,3,57,172,115
3,0,6,2,3,1,29,28
3,0,2,3,5,14,65,51
3,0,3,0,3,92,70,-22
3,0,0,2,3,110,30,-80
3,0,6,0,3,59,58,-1
3,0,0,4,3,24,1,-23
3,1,3,0,3,1035,113,-922
3,0,0,1,3,5,108,103
3,0,2,0,5,29,79,50
2,0,2,0,5,63,117,54
3,0,6,0,3,185,63,-122
3,0,3,4,3,21,86,65
3,1,3,0,3,41,71,30
3,0,5,0,3,69,6,-63
1,0,2,1,5,9,94,85
3,0,4,1,3,22,97,75
3,1,0,0,3,104,214,110
3,1,1,1,3,113,60,-53
0,1,3,7,3,81,79,-2
1,0,2,0,5,57,211,154
0,1,3,1,3,12,84,72
1,0,5,0,3,52,779,727
1,0,2,3,5,20,3,-17
3,0,6,1,3,30,46,16
3,0,6,1,3,14,32,18
3,0,3,4,3,101,22,-79
3,1,4,1,3,12,24,12
3,0,6,0,3,25,10,-15
2,0,2,2,5,156,6,-150
3,0,2,0,5,99,24,-75
3,0,0,4,3,147,60,-87
3,0,0,1,3,51,30,-21
3,0,3,0,3,5,28,23
3,0,2,0,5,89,26,-63
3,0,5,0,3,55,57,2
1,0,1,1,3,48,110,62
3,0,2,0,5,20,69,49
3,0,4,0,3,65,64,-1
1,0,2,2,5,35,144,109
1,0,2,0,5,61,57,-4
3,0,6,1,3,148,22,-126
3,1,0,4,3,98,63,-35
1,0,0,1,3,100,104,4
1,0,3,0,3,246,596,350
3,0,0,6,3,17,35,18
1,0,4,6,3,39,82,43
3,0,1,0,3,29,49,20
1,0,0,0,3,249,71,-178
1,0,0,0,3,1184,106,-1078
2,0,3,0,3,7,213,206
3,1,1,6,3,6,8,2
2,0,1,0,3,149,25,-124
3,0,6,1,3,20,18,-2
1,0,6,0,3,36,56,20
2,0,2,1,5,127,23,-104
3,0,5,1,3,7,28,21
3,0,3,6,3,21,24,3
1,0,3,0,3,76,118,42
1,0,3,0,3,115,88,-27
3,1,7,6,3,1,6,5
3,1,5,1,3,15,23,8
3,0,0,4,3,18,32,14
3,0,3,0,3,221,38,-183
3,0,0,0,3,57,64,7
1,0,5,1,3,66,4,-62
1,0,3,1,3,413,16,-397
3,0,0,0,3,68,22,-46
3,0,3,0,3,93,52,-41
1,0,2,1,5,33,76,43
3,0,4,0,3,183,173,-10
2,0,2,0,5,45,5,-40
3,0,5,0,3,54,18,-36
3,0,5,0,3,118,70,-48
3,0,6,0,3,41,61,20
3,0,2,3,5,35,25,-10
1,0,0,4,3,51,24,-27
1,0,0,0,3,160,73,-87
1,0,6,1,3,27,26,-1
3,0,1,4,3,9,12,3
3,1,7,5,3,2,4,2
1,0,2,1,5,10,42,32
3,1,7,5,3,3,5,2
1,0,0,0,3,51,1094,1043
1,0,2,3,5,9,5,-4
3,0,0,0,3,67,63,-4
1,0,4,0,3,178,66,-112
3,1,7,5,3,7,5,-2
3,0,5,2,3,80,9,-71
3,0,0,1,3,169,30,-139
3,1,0,0,3,83,229,146
1,0,6,4,3,29,12,-17
3,0,1,0,3,48,27,-21
2,0,2,0,5,36,106,70
3,0,2,0,5,475,76,-399
3,1,0,6,3,16,33,17
1,0,3,4,3,94,104,10
1,0,0,1,3,93,20,-73
1,0,3,0,3,846,69,-777
3,0,5,0,3,198,35,-163
2,0,3,0,3,77,144,67
2,0,3,0,3,125,95,-30
1,0,0,4,3,68,29,-39
1,0,0,6,3,94,18,-76
3,0,3,4,3,66,78,12
3,0,6,0,3,58,84,26
3,0,5,3,3,10,128,118
3,0,6,0,3,68,19,-49
2,0,0,1,3,114,41,-73
3,0,6,0,3,84,109,25
3,0,2,2,5,18,11,-7
1,0,3,0,3,90,131,41
3,0,1,0,3,311,14,-297
3,0,2,0,5,347,103,-244
3,1,0,0,3,121,46,-75
1,0,0,0,3,54,180,126
1,0,0,6,3,17,35,18
3,0,0,0,3,100,102,2
2,0,0,4,3,2,105,103
2,0,3,0,3,15,173,158
2,0,2,0,5,77,18,-59
1,0,4,1,3,112,24,-88
3,1,0,0,3,37,152,115
3,0,2,0,5,87,29,-58
3,1,0,4,3,46,12,-34
1,0,4,1,3,82,50,-32
1,0,3,0,3,66,4,-62
3,0,5,1,3,3,22,19
3,0,2,0,5,44,10,-34
3,0,6,1,3,7,75,68
3,0,5,0,3,129,53,-76
0,1,5,1,3,12,22,10
2,0,2,0,5,154,9,-145
3,0,0,4,3,19,62,43
1,0,6,0,3,44,21,-23
2,0,3,4,3,5,11,6
1,0,3,4,3,28,45,17
3,0,0,7,3,14,3,-11
1,0,1,1,3,21,42,21
3,0,0,0,3,67,72,5
1,0,3,4,3,64,121,57
3,0,3,0,3,92,87,-5
3,1,0,0,3,28,72,44
0,1,4,0,3,58,38,-20
3,0,6,1,3,100,1,-99
3,0,6,1,3,80,9,-71
1,0,0,0,3,156,51,-105
2,0,2,0,5,95,26,-69
0,1,5,1,3,284,3,-281
3,0,2,1,5,26,124,98
3,0,6,0,3,89,55,-34
1,0,5,0,3,242,41,-201
3,0,0,1,3,69,28,-41
3,0,3,0,3,13,79,66
1,0,6,2,3,9,30,21
3,0,1,2,3,20,26,6
3,1,4,4,3,23,41,18
2,0,2,0,5,156,73,-83
3,0,1,0,3,77,15,-62
3,1,3,0,3,21,86,65
3,0,2,1,5,57,68,11
3,0,0,1,3,94,7,-87
2,0,1,1,3,78,21,-57
3,0,0,0,3,79,76,-3
1,0,6,0,3,32,12,-20
3,0,5,1,3,44,12,-32
0,1,3,0,3,383,56,-327
3,0,5,1,3,538,15,-523
2,0,2,2,5,23,10,-13
0,1,5,0,3,24,40,16
1,0,0,0,3,67,110,43
1,0,3,7,3,105,11,-94
1,0,1,1,3,7,74,67
1,0,5,0,3,58,10,-48
3,0,2,2,5,48,64,16
3,0,1,6,3,11,23,12
1,0,0,0,3,165,84,-81
1,0,0,1,3,64,39,-25
3,0,6,0,3,57,40,-17
3,1,0,1,3,76,138,62
3,0,2,0,5,14,85,71
3,0,4,0,3,19,18,-1
1,0,1,0,3,139,107,-32
3,0,0,7,3,40,12,-28
3,0,4,2,3,54,18,-36
3,1,4,0,3,127,95,-32
1,0,0,0,3,84,63,-21
0,1,3,1,3,42,55,13
3,0,6,1,3,7,107,100
0,1,5,0,3,54,47,-7
2,0,2,0,5,25,48,23
3,0,0,0,3,38,62,24
3,0,6,1,3,9,131,122
2,0,3,0,3,304,67,-237
1,0,2,2,5,261,23,-238
3,0,4,2,3,41,304,263
1,0,0,0,3,50,77,27
1,1,0,1,3,29,410,381
3,1,5,2,3,29,5,-24
3,1,3,6,3,91,47,-44
1,0,1,0,3,94,25,-69
1,0,3,0,3,35,99,64
1,0,0,0,3,104,32,-72
2,0,3,0,3,129,153,24
3,0,6,0,3,191,47,-144
3,0,2,2,5,102,84,-18
3,1,4,0,3,116,6,-110
3,0,3,4,3,28,15,-13
0,1,3,0,3,17,170,153
3,0,2,1,5,19,86,67
2,0,0,6,3,139,94,-45
1,0,0,1,3,62,29,-33
1,0,6,2,3,8,9,1
2,0,0,1,3,73,85,12
1,0,0,1,3,99,101,2
1,0,5,0,3,192,66,-126
1,1,0,6,3,20,31,11
3,0,3,0,3,81,31,-50
1,0,0,6,3,47,303,256
3,1,0,0,3,47,210,163
3,1,4,7,3,29,1,-28
3,0,6,6,3,5,3,-2
3,0,6,0,3,60,32,-28
3,0,3,0,3,81,6,-75
3,0,2,0,5,89,85,-4
1,0,0,4,3,116,72,-44
3,0,0,4,3,60,17,-43
1,0,4,1,3,103,38,-65
3,1,0,4,3,70,20,-50
3,0,6,6,3,16,6,-10
1,0,3,1,3,96,140,44
3,0,2,0,5,58,10,-48
3,0,1,0,3,37,5,-32
3,1,6,2,3,19,7,-12
3,0,6,0,3,41,35,-6
3,1,3,0,3,30,10,-20
3,0,5,0,3,125,1,-124
2,0,3,1,3,236,25,-211
3,0,2,0,5,84,38,-46
3,1,1,0,3,40,33,-7
3,1,0,7,3,140,109,-31
2,0,3,0,3,104,39,-65
2,0,0,4,3,77,85,8
3,0,0,0,3,85,80,-5
3,1,0,1,3,17,76,59
3,1,1,1,3,36,2,-34
1,0,5,4,3,17,39,22
3,1,0,0,3,190,137,-53
1,0,1,6,3,85,32,-53
3,0,1,0,3,356,2,-354
1,0,3,0,3,3,143,140
3,0,0,6,3,31,10,-21
2,0,2,0,5,25,51,26
1,0,3,4,3,62,78,16
3,0,2,1,5,99,38,-61
3,1,0,0,3,103,13,-90
1,0,0,0,3,74,72,-2
3,0,4,0,3,111,172,61
1,0,6,0,3,28,15,-13
1,0,1,0,3,119,362,243
1,0,3,1,3,71,74,3
3,1,0,1,3,27,97,70
1,0,0,4,3,14,59,45
2,0,2,0,5,69,21,-48
3,0,0,0,3,89,65,-24
3,0,1,1,3,14,52,38
2,0,1,4,3,46,18,-28
3,0,2,1,5,36,27,-9
1,0,5,1,3,33,32,-1
3,0,6,1,3,75,13,-62
2,0,0,0,3,92,118,26
1,0,3,0,3,97,30,-67
2,0,2,0,5,589,96,-493
3,0,3,1,3,201,34,-167
3,0,6,1,3,41,10,-31
3,0,2,0,5,41,24,-17
2,0,1,0,3,1,39,38
1,0,2,2,5,13,31,18
3,0,5,2,3,22,15,-7
1,0,2,2,5,7,18,11
3,0,0,2,3,31,38,7
2,0,0,0,3,52,84,32
1,0,6,0,3,60,32,-28
1,0,2,1,5,35,192,157
2,0,3,1,3,59,17,-42
3,1,0,0,3,66,34,-32
1,0,2,3,5,79,2,-77
1,0,2,0,5,93,51,-42
3,1,0,0,3,354,39,-315
3,0,6,1,3,64,20,-44
3,0,3,2,3,42,31,-11
3,1,1,0,3,25,21,-4
3,0,0,1,3,15,188,173
3,0,5,0,3,43,21,-22
1,0,1,4,3,5,77,72
3,1,0,1,3,14,95,81
3,0,0,0,3,89,72,-17
1,0,6,1,3,35,36,1
1,0,0,0,3,99,33,-66
3,0,2,0,5,55,18,-37
2,0,2,1,5,157,28,-129
3,0,5,0,3,43,39,-4
3,0,1,4,3,30,10,-20
3,1,1,1,3,37,11,-26
1,0,3,0,3,95,35,-60
3,0,0,1,3,54,113,59
3,0,2,0,5,96,21,-75
1,0,2,2,5,39,61,22
3,0,2,0,5,113,37,-76
0,1,3,0,3,29,95,66
1,0,4,2,3,7,121,114
3,1,3,1,3,62,30,-32
3,0,6,0,3,62,39,-23
3,0,0,0,3,45,75,30
3,0,3,4,3,13,20,7
3,1,0,1,3,40,11,-29
1,0,3,0,3,230,81,-149
3,1,1,6,3,35,284,249
1,0,0,0,3,96,81,-15
3,1,4,0,3,39,33,-6
3,0,3,1,3,84,123,39
1,0,2,0,5,23,91,68
3,0,2,3,5,20,105,85
0,1,3,4,3,54,28,-26
3,1,3,4,3,20,203,183
3,0,0,0,3,87,85,-2
1,0,2,3,5,3,21,18
3,0,2,0,5,12,94,82
3,0,3,2,3,6,102,96
2,0,0,0,3,49,64,15
0,1,3,1,3,113,4,-109
1,0,3,0,3,63,53,-10
1,0,3,0,3,45,13,-32
3,1,3,0,3,78,144,66
1,0,3,0,3,67,191,124
2,0,2,2,5,34,13,-21
3,0,0,0,3,80,47,-33
3,1,1,0,3,66,83,17
2,0,3,0,3,89,103,14
2,0,0,0,3,77,61,-16
1,0,6,0,3,33,18,-15
3,0,3,1,3,163,5,-158
3,0,1,0,3,57,216,159
2,0,2,0,5,76,154,78
1,0,1,1,3,76,167,91
3,0,4,1,3,63,21,-42
2,0,3,6,3,99,13,-86
3,0,6,1,3,32,93,61
3,0,2,1,5,26,138,112
1,0,6,0,3,39,49,10
3,0,3,0,3,1061,164,-897
1,0,1,0,3,80,43,-37
3,1,0,0,3,317,90,-227
3,0,6,1,3,10,31,21
3,0,1,0,3,91,111,20
1,0,0,0,3,81,39,-42
2,0,0,0,3,198,74,-124
1,0,6,0,3,96,49,-47
3,0,2,0,5,122,203,81
1,0,0,0,3,45,55,10
1,0,5,2,3,41,14,-27
1,0,6,4,3,33,15,-18
1,0,2,2,5,12,27,15
2,0,1,0,3,291,27,-264
2,0,3,0,3,710,26,-684
3,0,2,1,5,69,3,-66
3,0,1,0,3,136,96,-40
1,0,3,0,3,46,43,-3
1,0,2,2,5,7,110,103
0,1,3,0,3,32,455,423
3,1,0,1,3,446,47,-399
3,1,0,0,3,142,64,-78
2,0,0,0,3,149,76,-73
3,0,0,0,3,57,497,440
2,0,3,6,3,30,31,1
1,0,6,6,3,3,17,14
3,0,5,1,3,3,47,44
2,0,3,0,3,15,84,69
3,0,3,0,3,84,23,-61
1,0,3,0,3,105,375,270
2,0,0,1,3,46,79,33
1,0,4,1,3,55,112,57
1,0,2,2,5,69,80,11
3,0,4,4,3,13,110,97
1,0,3,0,3,53,79,26
1,0,0,0,3,87,51,-36
2,0,2,2,5,27,8,-19
3,0,0,0,3,127,94,-33
1,0,2,0,5,41,155,114
0,1,5,6,3,21,1,-20
3,0,3,4,3,10,91,81
1,0,3,7,3,352,89,-263
3,0,1,1,3,120,41,-79
3,0,3,5,3,81,65,-16
3,0,2,3,5,8,14,6
3,1,0,0,3,142,233,91
3,0,0,0,3,48,7,-41
3,1,0,0,3,265,99,-166
3,0,2,1,5,64,7,-57
3,0,4,4,3,32,10,-22
1,0,1,0,3,108,66,-42
3,0,5,1,3,11,85,74
2,0,2,1,5,83,25,-58
3,0,4,4,3,59,11,-48
3,0,5,1,3,49,1,-48
3,0,4,1,3,75,314,239
3,1,0,0,3,350,58,-292
1,0,2,0,5,160,84,-76
1,0,2,0,5,19,1141,1122
3,0,0,0,3,118,135,17
1,0,0,0,3,43,100,57
3,0,4,1,3,61,51,-10
3,0,5,0,3,10,28,18
3,0,0,0,3,16,37,21
3,1,0,0,3,90,205,115
1,0,3,0,3,49,133,84
3,1,0,1,3,106,5,-101
3,0,0,0,3,70,29,-41
3,0,0,0,3,62,127,65
1,0,0,0,3,188,119,-69
2,0,0,1,3,13,29,16
1,0,1,0,3,80,70,-10
3,0,6,1,3,49,35,-14
1,0,0,4,3,53,65,12
1,0,6,0,3,29,78,49
3,0,0,0,3,79,56,-23
3,0,4,2,3,231,3,-228
3,0,4,2,3,65,98,33
3,0,6,4,3,23,7,-16
3,0,0,1,3,35,91,56
3,0,6,1,3,2,21,19
3,0,6,4,3,15,9,-6
2,0,0,4,3,68,133,65
3,1,3,0,3,73,17,-56
1,0,2,2,5,2,35,33
3,1,6,0,3,47,31,-16
1,0,6,1,3,10,20,10
1,0,3,0,3,105,102,-3
1,0,0,0,3,167,265,98
3,0,0,0,3,129,134,5
3,0,2,0,5,15,40,25
1,0,0,0,3,26,35,9
1,0,2,0,5,12,64,52
3,0,5,3,3,15,36,21
1,0,3,0,3,311,31,-280
3,1,4,0,3,27,127,100
1,0,5,1,3,6,118,112
3,0,5,2,3,88,68,-20
1,0,0,1,3,64,107,43
3,0,6,4,3,1,5,4
1,0,6,0,3,28,27,-1
3,0,1,4,3,42,32,-10
3,0,2,6,5,9,4,-5
3,0,0,0,3,72,74,2
1,0,2,0,5,18,197,179
3,1,6,0,3,16,28,12
3,1,0,6,3,141,156,15
1,0,0,1,3,15,152,137
1,0,0,1,3,25,68,43
3,1,0,0,3,32,60,28
2,0,3,0,3,103,75,-28
3,0,6,0,3,34,26,-8
3,0,3,4,3,21,125,104
3,1,1,0,3,22,14,-8
3,0,5,0,3,23,1,-22
1,0,3,1,3,101,21,-80
1,0,0,7,3,97,14,-83
3,1,1,0,3,61,119,58
0,1,3,0,3,43,34,-9
3,0,1,4,3,11,5,-6
3,0,5,2,3,1,35,34
1,0,0,0,3,75,62,-13
1,0,0,1,3,67,42,-25
3,0,0,0,3,111,60,-51
1,0,1,0,3,40,49,9
3,1,4,0,3,114,11,-103
3,1,0,4,3,15,36,21
1,0,3,1,3,10,138,128
3,0,0,4,3,120,272,152
3,0,2,0,5,15,50,35
2,0,2,0,5,15,81,66
3,0,0,0,3,48,41,-7
3,0,3,0,3,137,146,9
1,0,5,1,3,93,48,-45
2,0,2,6,5,2,9,7
2,0,2,0,5,37,82,45
2,0,1,1,3,57,60,3
1,0,0,0,3,64,105,41
3,0,2,1,5,220,36,-184
3,0,2,1,5,3,81,78
1,0,3,0,3,157,94,-63
3,0,0,1,3,60,13,-47
3,1,7,6,3,6,1,-5
3,0,6,2,3,12,46,34
0,1,3,0,3,11,69,58
1,0,6,4,3,5,65,60
1,0,3,1,3,36,56,20
3,0,0,4,3,31,25,-6
1,0,6,0,3,37,14,-23
3,0,2,6,5,12,9,-3
3,0,4,0,3,93,276,183
1,0,3,0,3,20,67,47
3,0,1,4,3,102,43,-59
3,0,0,4,3,24,47,23
3,0,3,0,3,46,28,-18
3,1,1,1,3,17,48,31
3,0,0,1,3,34,92,58
1,0,5,0,3,55,130,75
3,1,0,1,3,64,23,-41
2,0,3,0,3,66,148,82
2,0,0,1,3,52,17,-35
1,0,0,0,3,27,43,16
3,0,3,0,3,93,65,-28
1,0,0,6,3,20,10,-10
3,0,5,2,3,25,108,83
1,0,0,1,3,57,41,-16
0,1,5,0,3,78,64,-14
3,0,2,1,5,17,117,100
2,0,2,0,5,97,35,-62
2,0,3,0,3,280,47,-233
3,0,6,6,3,13,6,-7
3,0,5,0,3,83,66,-17
3,0,3,4,3,53,61,8
3,1,0,0,3,94,128,34
1,0,0,7,3,8,79,71
1,0,2,0,5,9,101,92
1,0,3,0,3,70,56,-14
1,0,6,1,3,25,83,58
3,0,0,0,3,94,84,-10
3,0,0,0,3,41,26,-15
3,0,3,6,3,2,29,27
2,0,3,7,3,111,166,55
3,1,6,0,3,16,30,14
1,0,3,1,3,82,103,21
3,1,1,0,3,24,52,28
3,0,0,1,3,66,43,-23
1,0,0,1,3,231,43,-188
3,0,6,0,3,91,18,-73
3,0,3,4,3,28,74,46
1,0,5,1,3,99,69,-30
1,0,5,0,3,34,19,-15
0,1,3,0,3,3,94,91
1,0,0,4,3,63,60,-3
3,0,3,0,3,106,120,14
2,0,2,2,5,5,40,35
3,1,0,4,3,49,10,-39
1,0,1,2,3,43,81,38
3,0,2,0,5,57,71,14
1,0,4,4,3,44,29,-15
3,1,6,1,3,69,15,-54
3,0,2,0,5,162,115,-47
3,0,2,1,5,768,87,-681
3,0,0,0,3,184,49,-135
1,0,0,1,3,72,57,-15
3,0,6,1,3,45,22,-23
2,0,0,0,3,91,63,-28
3,0,3,0,3,12,63,51
3,1,3,0,3,6,402,396
3,1,0,1,3,24,88,64
3,1,0,1,3,94,62,-32
3,0,3,6,3,16,193,177
3,0,2,0,5,22,144,122
3,0,6,0,3,41,75,34
3,0,5,2,3,32,21,-11
1,0,3,5,3,37,59,22
1,0,1,4,3,19,7,-12
1,0,2,1,5,7,145,138
3,0,6,0,3,84,40,-44
2,0,0,0,3,67,61,-6
1,0,1,1,3,69,78,9
3,1,0,1,3,52,105,53
1,0,0,6,3,47,35,-12
1,0,6,0,3,73,83,10
3,0,1,0,3,87,61,-26
2,0,3,0,3,103,73,-30
3,1,1,0,3,22,45,23
2,0,1,4,3,98,23,-75
3,1,1,0,3,4,39,35
1,0,2,1,5,125,31,-94
1,0,3,0,3,48,141,93
3,0,5,0,3,29,110,81
3,0,2,0,5,81,116,35
3,0,2,1,5,28,56,28
1,0,3,0,3,45,54,9
1,0,3,0,3,53,36,-17
3,0,2,0,5,116,50,-66
2,0,2,4,5,7,41,34
3,0,2,2,5,106,7,-99
3,0,6,1,3,44,16,-28
3,0,2,0,5,15,104,89
1,0,6,1,3,11,54,43
0,1,5,0,3,22,25,3
1,0,1,6,3,25,32,7
2,0,2,4,5,2,38,36
3,0,6,2,3,2,560,558
3,0,0,6,3,16,74,58
3,0,6,1,3,29,13,-16
2,0,3,6,3,12,17,5
1,0,5,1,3,41,10,-31
3,1,0,0,3,115,140,25
1,0,0,4,3,148,35,-113
1,0,6,0,3,64,43,-21
3,0,3,4,3,134,84,-50
3,0,4,1,3,11,38,27
3,0,6,2,3,8,144,136
3,0,1,1,3,10,55,45
3,1,3,0,3,125,13,-112
0,1,3,0,3,60,252,192
3,0,6,6,3,7,2,-5
1,0,0,1,3,47,72,25
3,0,5,2,3,15,18,3
3,0,2,0,5,114,87,-27
1,0,3,0,3,107,45,-62
3,1,3,1,3,70,138,68
3,0,1,1,3,75,8,-67
2,0,2,0,5,125,20,-105
1,0,0,0,3,49,64,15
0,1,3,0,3,3,117,114
1,0,0,6,3,35,13,-22
3,0,5,0,3,30,29,-1
2,0,0,1,3,145,43,-102
3,0,6,0,3,59,41,-18
3,0,0,0,3,62,65,3
1,0,5,0,3,26,33,7
1,0,3,0,3,115,77,-38
0,1,3,0,3,133,64,-69
2,0,2,0,5,25,186,161
2,0,3,1,3,96,35,-61
1,0,6,1,3,9,97,88
3,0,5,2,3,10,58,48
3,0,1,1,3,37,90,53
1,0,2,3,5,1,15,14
3,1,0,0,3,46,55,9
1,0,3,4,3,57,78,21
3,0,6,1,3,11,47,36
3,0,0,1,3,60,17,-43
3,1,1,0,3,27,75,48
1,0,2,3,5,15,1,-14
2,0,3,0,3,8,114,106
1,0,0,1,3,5,55,50
3,0,3,0,3,104,107,3
1,0,3,4,3,96,104,8
3,1,0,1,3,17,129,112
3,0,4,1,3,3,232,229
3,1,6,1,3,4,76,72
3,0,0,1,3,272,174,-98
3,0,0,0,3,75,58,-17
3,1,3,0,3,65,63,-2
3,0,5,1,3,32,79,47
3,0,2,1,5,5,35,30
2,0,3,0,3,85,61,-24
3,1,0,4,3,118,23,-95
3,0,4,1,3,141,70,-71
3,0,5,4,3,3,7,4
3,0,1,0,3,1244,22,-1222
3,0,3,4,3,52,32,-20
1,0,4,0,3,104,129,25
1,0,0,0,3,157,82,-75
3,0,2,2,5,135,24,-111
3,0,2,0,5,4,148,144
1,0,0,1,3,63,190,127
3,1,4,6,3,32,12,-20
3,0,6,1,3,46,36,-10
3,0,2,1,5,38,18,-20
3,1,1,1,3,35,11,-24
1,0,0,1,3,54,69,15
1,0,5,0,3,68,23,-45
2,0,0,4,3,12,60,48
3,0,1,1,3,35,2,-33
2,0,2,1,5,25,88,63
0,1,5,1,3,19,31,12
3,1,1,0,3,59,50,-9
3,0,6,0,3,39,16,-23
1,0,0,0,3,101,67,-34
3,0,3,4,3,53,81,28
3,0,2,1,5,25,35,10
3,1,0,6,3,25,28,3
3,0,2,0,5,140,42,-98
3,0,5,0,3,43,98,55
3,0,3,0,3,75,121,46
3,0,6,1,3,101,32,-69
3,0,6,0,3,83,560,477
3,1,3,4,3,42,79,37
3,0,2,1,5,77,21,-56
3,0,0,1,3,461,59,-402
3,0,3,6,3,7,35,28
1,0,5,0,3,68,9,-59
3,0,6,1,3,75,20,-55
2,0,2,2,5,35,133,98
1,0,2,1,5,279,21,-258
3,0,2,0,5,134,75,-59
1,0,5,0,3,22,29,7
3,1,0,1,3,119,96,-23
1,0,3,0,3,52,150,98
1,0,0,0,3,98,43,-55
0,1,3,0,3,41,15,-26
1,0,4,0,3,147,267,120
2,0,0,0,3,39,103,64
3,0,1,1,3,45,22,-23
1,0,0,1,3,104,36,-68
1,0,1,1,3,5,25,20
1,0,0,0,3,99,106,7
1,0,0,1,3,34,84,50
0,1,3,0,3,20,79,59
1,0,6,2,3,15,1,-14
3,0,5,1,3,45,40,-5
3,0,3,4,3,5,24,19
1,0,1,6,3,25,8,-17
3,0,2,0,5,26,64,38
1,0,6,1,3,7,118,111
0,1,3,1,3,19,50,31
1,0,4,2,3,65,33,-32
3,0,2,1,5,79,276,197
1,0,0,0,3,32,103,71
1,0,0,1,3,57,18,-39
3,0,4,0,3,87,78,-9
3,1,0,4,3,60,41,-19
3,0,5,2,3,37,26,-11
1,0,6,0,3,96,49,-47
3,1,0,6,3,40,55,15
1,0,0,0,3,96,72,-24
1,0,1,2,3,30,140,110
3,0,4,2,3,55,103,48
3,0,5,2,3,35,37,2
3,1,0,4,3,11,52,41
3,0,5,0,3,82,21,-61
1,0,3,4,3,105,104,-1
3,0,3,6,3,12,16,4
3,1,7,5,3,5,8,3
2,0,2,2,5,36,7,-29
3,0,2,3,5,27,9,-18
3,1,0,4,3,10,144,134
3,1,3,6,3,55,36,-19
3,1,3,0,3,26,252,226
3,0,5,1,3,2,30,28
0,1,3,0,3,21,68,47
1,0,0,0,3,78,42,-36
3,0,2,0,5,30,120,90
3,0,4,2,3,18,49,31
3,1,0,0,3,55,89,34
3,1,0,1,3,128,54,-74
3,1,3,0,3,99,244,145
3,0,2,0,5,58,27,-31
1,1,0,4,3,49,65,16
2,0,1,0,3,28,19,-9
3,0,6,2,3,8,29,21
3,1,0,6,3,7,71,64
3,0,6,4,3,22,19,-3
3,1,1,4,3,28,25,-3
3,1,0,6,3,16,21,5
2,0,2,0,5,21,86,65
3,0,5,1,3,139,14,-125
3,0,2,7,5,1,3,2
2,0,3,0,3,1494,37,-1457
1,0,2,1,5,158,92,-66
3,0,6,0,3,54,136,82
3,0,5,0,3,70,57,-13
3,1,6,0,3,33,37,4
3,1,7,5,3,5,4,-1
2,0,0,0,3,24,56,32
1,0,2,0,5,102,93,-9
1,0,3,0,3,157,123,-34
1,0,1,1,3,9,65,56
2,0,0,0,3,220,63,-157
3,1,4,4,3,6,13,7
3,0,6,1,3,27,53,26
1,0,3,4,3,20,136,116
1,0,0,1,3,110,36,-74
3,1,1,0,3,134,7,-127
1,0,3,0,3,110,51,-59
3,1,7,7,3,3,4,1
3,0,0,1,3,1042,135,-907
3,0,0,1,3,75,95,20
1,0,1,0,3,14,48,34
1,0,0,1,3,49,156,107
3,1,6,0,3,105,79,-26
3,0,0,7,3,6,112,106
3,0,0,1,3,293,37,-256
3,0,1,1,3,149,43,-106
3,0,2,1,5,6,32,26
2,0,0,4,3,55,95,40
3,1,0,1,3,17,291,274
3,0,3,0,3,114,105,-9
2,0,0,4,3,21,170,149
1,0,3,0,3,12,92,80
1,0,0,0,3,57,141,84
3,1,3,0,3,82,81,-1
1,1,0,4,3,87,153,66
1,0,3,0,3,43,30,-13
3,0,2,0,5,5,214,209
3,1,0,0,3,39,61,22
3,0,6,1,3,153,52,-101
1,0,4,7,5,59,44,-15
2,0,0,1,3,95,24,-71
1,0,2,0,5,37,11,-26
1,0,3,1,3,17,65,48
3,1,0,0,3,82,110,28
3,0,6,2,3,31,7,-24
3,1,1,1,3,18,29,11
2,0,1,6,3,14,41,27
3,1,4,1,3,6,73,67
3,0,0,6,3,34,6,-28
3,0,2,0,5,87,80,-7
1,0,4,6,3,129,38,-91
1,0,0,1,3,129,26,-103
1,0,0,4,3,1345,28,-1317
1,0,0,1,3,32,114,82
3,0,6,3,3,67,5,-62
3,0,4,4,3,8,116,108
2,0,0,1,3,54,37,-17
1,0,3,0,3,278,63,-215
3,0,5,0,3,26,37,11
1,0,3,7,3,3,134,131
1,0,5,1,3,22,21,-1
1,0,2,2,5,57,18,-39
3,0,4,4,3,61,23,-38
1,0,1,0,3,90,72,-18
2,0,2,1,5,69,10,-59
3,0,2,0,5,75,246,171
1,0,0,0,3,62,756,694
2,0,1,4,3,13,32,19
1,0,2,0,5,96,218,122
3,1,0,6,3,17,19,2
3,0,5,1,3,10,27,17
3,1,4,0,3,112,28,-84
3,1,5,0,3,42,28,-14
1,0,0,1,3,46,70,24
1,0,0,4,3,71,94,23
3,1,3,7,3,58,17,-41
1,0,0,0,3,142,101,-41
1,0,2,1,5,103,31,-72
3,0,3,4,3,63,3,-60
3,0,1,0,3,56,417,361
3,0,2,1,5,86,29,-57
1,0,0,0,3,75,61,-14
3,0,6,6,3,13,2,-11
3,1,3,0,3,55,77,22
3,0,6,7,3,18,8,-10
3,0,2,1,5,28,60,32
3,0,0,0,3,46,24,-22
1,0,5,2,3,8,93,85
1,0,3,7,3,17,61,44
3,0,0,4,3,31,83,52
2,0,0,0,3,97,190,93
3,0,6,4,3,6,2,-4
3,0,4,4,3,48,27,-21
1,0,5,0,3,35,112,77
2,0,0,0,3,69,155,86
3,0,0,0,3,167,40,-127
2,0,3,0,3,66,104,38
3,1,3,0,3,45,32,-13
3,0,3,0,3,68,-1,-69
3,0,6,2,3,5,39,34
1,0,6,0,3,38,36,-2
0,1,3,0,3,19,109,90
2,0,2,0,5,188,5,-183
3,0,0,0,3,29,57,28
3,0,1,0,3,152,23,-129
2,0,3,1,3,8,48,40
3,0,3,0,3,475,113,-362
3,0,0,4,3,41,42,1
3,0,6,0,3,54,71,17
3,0,6,1,3,20,7,-13
1,0,0,0,3,55,86,31
3,0,0,0,3,56,48,-8
1,0,0,1,3,10,101,91
1,0,6,4,3,5,11,6
3,1,0,0,3,183,89,-94
2,0,0,4,3,21,3,-18
1,0,3,1,3,762,70,-692
3,1,0,0,3,67,69,2
3,0,4,0,3,93,71,-22
2,0,3,0,3,277,115,-162
3,0,3,1,3,70,48,-22
0,1,5,1,3,18,35,17
3,0,2,0,5,33,88,55
3,0,6,1,3,15,32,17
1,0,3,1,3,110,16,-94
3,0,2,0,5,119,123,4
3,0,0,0,3,92,63,-29
3,0,5,2,3,19,14,-5
3,1,0,1,3,34,53,19
0,1,3,7,3,24,4,-20
1,0,6,4,3,2,7,5
0,1,3,0,3,55,17,-38
3,1,0,0,3,29,104,75
2,0,2,0,5,69,90,21
3,0,2,1,5,47,48,1
3,0,0,1,3,58,82,24
3,1,0,0,3,70,93,23
3,0,0,6,3,24,87,63
3,1,0,7,3,10,36,26
3,0,5,0,3,123,106,-17
3,0,3,0,3,81,82,1
3,0,1,4,3,15,6,-9
3,0,1,1,3,31,1,-30
3,1,1,0,3,62,31,-31
3,1,1,0,3,10,107,97
3,0,2,2,5,19,12,-7
3,0,2,1,5,110,28,-82
2,0,3,0,3,57,106,49
3,0,6,0,3,179,37,-142
1,0,4,1,3,50,15,-35
1,0,6,0,3,37,72,35
3,0,0,7,3,3,48,45
1,0,1,0,3,72,159,87
3,0,4,1,3,19,78,59
2,0,0,6,3,127,95,-32
3,1,1,1,3,3,49,46
3,0,2,4,5,6,3,-3
3,0,0,0,3,75,23,-52
3,0,0,0,3,87,185,98
0,1,3,4,3,35,36,1
3,0,1,0,3,46,40,-6
3,0,6,3,3,1,14,13
3,0,6,1,3,1,51,50
1,0,6,2,3,17,5,-12
3,0,6,0,3,51,100,49
1,0,0,7,3,73,95,22
1,0,1,0,3,21,62,41
3,0,1,0,3,125,93,-32
0,1,3,0,3,52,124,72
1,0,3,6,3,40,4,-36
2,0,0,0,3,54,82,28
3,0,1,0,3,19,74,55
3,0,2,0,5,108,77,-31
1,0,6,0,3,40,44,4
1,0,5,1,3,25,8,-17
3,0,2,0,5,120,64,-56
1,0,3,0,3,51,79,28
2,0,1,0,3,8,50,42
3,0,2,0,5,62,136,74
3,0,2,2,5,25,14,-11
1,0,1,7,3,63,1,-62
1,0,3,6,3,68,139,71
3,0,3,2,3,68,39,-29
3,1,0,4,3,55,242,187
3,1,5,0,3,24,39,15
3,0,6,1,3,8,67,59
3,1,0,1,3,10,82,72
0,1,3,0,3,60,79,19
1,0,6,4,3,8,17,9
3,0,6,0,3,115,30,-85
3,0,3,0,3,47,45,-2
3,0,5,1,3,80,13,-67
1,0,4,2,3,34,59,25
1,0,6,1,3,26,34,8
3,0,0,0,3,82,141,59
3,0,3,1,3,65,21,-44
3,0,3,0,3,36,143,107
1,0,4,1,3,93,30,-63
1,0,1,0,3,133,162,29
3,1,0,1,3,132,16,-116
1,0,2,0,5,104,8,-96
1,0,3,1,3,87,1055,968
2,0,2,2,5,145,32,-113
1,0,5,0,3,6,39,33
3,0,0,0,3,34,63,29
3,1,0,0,3,308,203,-105
1,0,0,0,3,264,143,-121
1,0,3,7,3,14,8,-6
1,0,0,1,3,207,65,-142
3,0,0,4,3,61,34,-27
3,0,4,0,3,622,143,-479
3,1,0,0,3,68,22,-46
3,0,5,0,3,39,21,-18
3,0,1,0,3,348,389,41
2,0,0,0,3,163,248,85
1,0,0,0,3,676,79,-597
1,0,5,6,3,70,7,-63
3,0,3,0,3,129,174,45
3,1,5,1,3,36,2,-34
3,1,4,6,3,122,30,-92
1,0,3,1,3,24,87,63
3,0,0,0,3,53,141,88
3,1,3,1,3,106,26,-80
0,1,3,0,3,124,8,-116
2,0,0,4,3,42,52,10
1,0,4,1,3,107,103,-4
3,1,5,1,3,22,12,-10
3,0,2,0,5,84,208,124
1,0,0,1,3,9,49,40
3,0,2,1,5,12,96,84
3,0,2,6,5,28,1,-27
3,0,0,0,3,56,79,23
1,0,0,1,3,138,1,-137
3,0,6,0,3,92,36,-56
1,0,0,0,3,108,248,140
3,0,6,2,3,51,5,-46
2,0,3,7,3,1,23,22
1,0,3,0,3,132,917,785
1,0,0,4,3,79,61,-18
3,1,1,4,3,55,8,-47
1,0,3,0,3,80,128,48
1,0,2,0,5,215,94,-121
3,1,0,0,3,90,46,-44
2,0,0,0,3,85,51,-34
3,1,3,0,3,45,35,-10
1,0,1,4,3,9,91,82
3,0,0,0,3,75,91,16
1,0,2,3,5,9,18,9
3,1,0,0,3,39,91,52
3,0,4,0,3,466,90,-376
0,1,3,1,3,57,78,21
1,0,4,0,3,69,27,-42
1,0,6,0,3,27,54,27
3,0,2,0,5,21,95,74
3,0,3,0,3,138,56,-82
3,0,1,0,3,8,97,89
1,0,3,4,3,107,108,1
3,0,3,4,3,101,162,61
3,1,4,0,3,120,109,-11
3,0,1,0,3,17,90,73
1,0,6,1,3,54,15,-39
1,0,2,2,5,34,7,-27
1,0,6,0,3,99,91,-8
1,0,0,0,3,102,35,-67
1,0,4,1,3,111,52,-59
1,0,2,0,5,16,40,24
2,0,1,1,3,18,14,-4
1,0,0,0,3,119,46,-73
1,0,0,4,3,50,87,37
3,1,0,4,3,77,9,-68
1,0,0,1,3,75,351,276
3,0,6,0,3,63,70,7
3,1,0,4,3,28,7,-21
2,0,2,2,5,8,34,26
2,0,3,6,3,130,5,-125
1,0,1,0,3,29,64,35
3,0,0,1,3,134,31,-103
2,0,2,3,5,7,82,75
3,0,5,0,3,67,30,-37
1,0,2,2,5,25,11,-14
3,0,5,3,3,8,10,2
3,1,0,0,3,252,34,-218
1,0,0,0,3,224,261,37
1,0,4,0,3,7,113,106
3,0,6,1,3,7,83,76
3,0,0,0,3,88,93,5
3,1,1,0,3,64,3,-61
3,0,3,0,3,8,137,129
1,0,3,0,3,56,15,-41
1,0,0,1,3,59,45,-14
3,0,2,0,5,73,9,-64
2,0,3,0,3,83,97,14
1,0,3,0,3,70,53,-17
3,0,6,1,3,7,77,70
1,0,5,0,3,33,46,13
3,0,2,1,5,10,49,39
1,0,1,1,3,19,40,21
3,0,2,0,5,17,54,37
1,0,0,1,3,76,65,-11
1,0,0,1,3,36,99,63
1,0,1,1,3,51,14,-37
1,0,6,0,3,115,61,-54
2,0,2,7,5,2,1,-1
3,0,3,1,3,3,42,39
1,0,0,6,3,101,17,-84
2,0,0,2,3,3,78,75
3,0,2,0,5,57,80,23
1,0,0,4,3,303,57,-246
3,0,0,4,3,27,28,1
3,0,1,0,3,125,96,-29
3,0,0,4,3,1,24,23
3,1,7,7,3,5,1,-4
3,1,4,0,3,69,81,12
3,1,4,0,3,20,11,-9
1,0,6,3,3,13,1,-12
2,0,0,0,3,96,81,-15
3,0,0,1,3,3,54,51
3,1,3,1,3,43,57,14
3,1,0,4,3,20,38,18
2,0,3,0,3,88,24,-64
3,0,6,3,3,26,239,213
3,0,2,1,5,207,11,-196
3,0,2,1,5,37,107,70
3,0,0,6,3,38,12,-26
2,0,2,1,5,204,203,-1
3,0,6,0,3,40,91,51
0,1,3,4,3,9,69,60
1,0,0,0,3,52,89,37
3,1,3,6,3,62,6,-56
1,0,0,1,3,21,83,62
3,0,0,4,3,36,53,17
3,0,0,0,3,62,63,1
1,0,6,1,3,7,33,26
2,0,2,0,5,22,43,21
1,0,3,0,3,94,142,48
3,0,2,0,5,8,33,25
3,0,2,1,5,26,67,41
2,0,2,2,5,23,6,-17
1,0,0,0,3,90,57,-33
3,1,3,1,3,98,143,45
3,0,5,1,3,97,15,-82
3,0,2,0,5,41,117,76
3,0,3,1,3,109,22,-87
1,0,4,1,3,10,55,45
2,0,3,1,3,10,70,60
1,0,4,0,3,56,85,29
1,0,6,0,3,13,52,39
1,0,0,1,3,80,23,-57
1,0,3,1,3,103,96,-7
1,0,0,0,3,81,84,3
1,0,6,0,3,20,44,24
3,0,2,0,5,23,44,21
3,0,3,0,3,353,124,-229
3,0,6,4,3,3,9,6
1,0,1,4,3,38,101,63
1,0,0,0,3,78,58,-20
2,0,3,0,3,129,193,64
3,1,0,0,3,108,11,-97
3,0,5,1,3,40,5,-35
1,0,2,1,5,84,96,12
1,0,0,0,3,77,136,59
1,0,3,4,3,89,92,3
1,0,2,1,5,25,92,67
3,0,0,0,3,92,243,151
0,1,3,4,3,54,122,68
1,0,5,6,3,11,9,-2
1,0,5,0,3,38,45,7
3,0,5,1,3,33,59,26
1,0,4,1,3,47,140,93
1,0,4,1,3,4,69,65
2,0,3,0,3,64,217,153
3,0,0,1,3,65,13,-52
3,1,0,0,3,216,74,-142
3,0,2,1,5,108,24,-84
0,1,3,0,3,14,85,71
3,0,3,0,3,54,5,-49
3,1,3,0,3,30,2,-28
2,0,3,0,3,46,31,-15
2,0,1,1,3,83,30,-53
3,0,2,3,5,65,18,-47
2,0,1,1,3,107,18,-89
3,0,6,0,3,32,59,27
3,0,2,2,5,2,119,117
3,1,1,4,3,3,21,18
2,0,0,1,3,14,66,52
1,0,2,0,5,162,186,24
3,1,3,0,3,139,7,-132
3,0,6,0,3,17,37,20
1,0,0,4,3,5,60,55
3,0,1,6,3,11,34,23
3,0,2,0,5,52,525,473
3,0,6,2,3,217,14,-203
3,0,4,4,3,28,6,-22
1,0,3,0,3,25,131,106
3,0,2,1,5,79,21,-58
1,1,0,7,3,92,48,-44
3,0,5,1,3,84,2,-82
3,0,3,0,3,30,51,21
1,0,3,7,3,53,50,-3
1,0,4,0,3,83,93,10
3,0,4,1,3,28,111,83
3,0,3,0,3,88,128,40
3,0,4,6,3,32,57,25
1,0,2,3,5,37,7,-30
1,1,0,0,3,110,109,-1
3,0,1,1,3,71,23,-48
2,0,1,0,3,11,22,11
3,0,4,1,3,38,143,105
3,1,3,1,3,73,90,17
3,0,0,1,3,10,106,96
3,0,0,4,3,56,29,-27
1,0,6,3,3,13,9,-4
1,0,6,0,3,113,11,-102
3,1,0,4,3,31,153,122
1,0,0,0,3,55,56,1
1,1,0,1,3,23,131,108
3,0,6,0,3,57,72,15
1,0,2,0,5,305,6,-299
3,1,0,0,3,194,46,-148
2,0,3,0,3,57,77,20
2,0,0,1,3,60,38,-22
1,0,3,0,3,65,75,10
3,1,3,4,3,22,414,392
3,1,0,1,3,113,66,-47
3,1,6,1,3,16,179,163
1,0,1,4,3,6,30,24
3,0,5,2,3,41,59,18
3,0,3,0,3,35,112,77
1,0,0,1,3,3,63,60
3,0,2,1,5,134,18,-116
2,0,2,0,5,99,162,63
2,0,1,0,3,99,14,-85
2,0,2,2,5,195,35,-160
1,0,3,0,3,82,133,51
1,0,0,0,3,123,101,-22
3,0,2,3,5,10,32,22
1,0,1,6,3,63,104,41
1,0,0,0,3,68,79,11
1,1,0,1,3,77,31,-46
3,1,4,4,3,33,129,96
3,0,0,1,3,28,22,-6
3,0,0,6,3,54,63,9
3,0,0,1,3,21,79,58
1,0,2,1,5,95,19,-76
1,0,3,4,3,114,53,-61
3,0,1,0,3,100,65,-35
3,1,0,1,3,113,27,-86
2,0,0,1,3,48,475,427
2,0,2,0,5,92,24,-68
3,0,0,0,3,53,116,63
3,0,2,0,5,41,241,200
1,0,0,0,3,386,40,-346
1,0,6,1,3,36,263,227
3,0,0,1,3,439,156,-283
3,1,0,0,3,218,49,-169
3,0,0,1,3,102,34,-68
1,0,1,0,3,155,70,-85
3,0,6,4,3,9,2,-7
2,0,2,1,5,18,156,138
1,0,0,1,3,22,47,25
1,0,0,0,3,83,101,18
2,0,3,4,3,46,84,38
2,0,2,1,5,12,47,35
1,0,0,1,3,81,31,-50
2,0,0,0,3,216,273,57
1,0,2,1,5,37,82,45
2,0,0,1,3,2,85,83
3,0,0,0,3,6,118,112
1,0,3,7,3,95,65,-30
3,0,6,1,3,11,29,18
0,1,3,0,3,521,43,-478
3,0,0,0,3,64,57,-7
3,0,1,1,3,39,25,-14
3,0,3,0,3,37,175,138
1,0,3,4,3,81,122,41
2,0,1,0,3,72,110,38
1,0,2,1,5,90,25,-65
0,1,5,4,3,40,6,-34
1,0,5,0,3,10,66,56
1,0,6,1,3,26,17,-9
3,0,5,0,3,311,66,-245
1,0,3,1,3,72,82,10
3,0,1,4,3,13,45,32
1,0,3,1,3,7,93,86
2,0,2,0,5,103,27,-76
1,0,2,4,5,2,9,7
3,0,3,4,3,22,18,-4
3,0,5,0,3,57,150,93
1,0,5,0,3,5,28,23
1,0,5,0,3,8,37,29
1,0,2,0,5,23,59,36
3,0,0,0,3,162,83,-79
3,1,0,0,3,37,78,41
1,0,2,0,5,82,121,39
3,0,2,1,5,11,71,60
1,0,6,1,3,49,15,-34
3,0,1,0,3,17,38,21
2,0,2,0,5,58,71,13
3,0,2,0,5,125,77,-48
3,1,0,0,3,211,74,-137
1,0,5,4,3,40,68,28
1,0,3,0,3,96,116,20
1,0,3,1,3,99,46,-53
3,0,1,4,3,7,20,13
1,0,3,1,3,31,101,70
3,0,6,1,3,22,8,-14
1,0,2,0,5,86,65,-21
3,0,5,1,3,31,85,54
2,0,2,1,5,16,109,93
3,0,3,0,3,97,81,-16
3,0,1,1,3,9,65,56
3,1,0,4,3,29,156,127
1,0,3,1,3,69,131,62
3,0,2,0,5,13,73,60
2,0,3,0,3,110,85,-25
1,0,0,0,3,839,59,-780
1,0,5,1,3,39,6,-33
2,0,2,0,5,47,155,108
1,0,4,0,3,125,178,53
2,0,2,2,5,44,34,-10
1,0,0,1,3,102,53,-49
3,0,4,4,3,32,434,402
3,0,0,1,3,26,41,15
1,0,3,1,3,188,15,-173
1,0,3,0,3,73,37,-36
3,1,3,6,3,7,33,26
3,0,0,0,3,56,52,-4
1,0,0,7,3,95,21,-74
3,0,6,4,3,4,9,5
3,0,0,1,3,97,42,-55
3,0,4,0,3,109,260,151
3,0,2,0,5,72,119,47
3,0,3,4,3,72,11,-61
2,0,3,6,3,27,30,3
2,0,2,0,5,2,65,63
1,0,3,4,3,103,92,-11
1,0,6,0,3,132,47,-85
3,0,6,2,3,52,40,-12
1,1,0,4,3,118,57,-61
3,0,1,1,3,1,42,41
2,0,2,0,5,48,40,-8
3,1,1,1,3,7,56,49
2,0,2,0,5,70,44,-26
1,0,1,7,3,10,21,11
3,0,5,0,3,67,92,25
3,0,2,0,5,35,78,43
1,0,2,1,5,27,243,216
3,1,3,1,3,50,42,-8
3,0,0,1,3,15,69,54
1,0,3,0,3,36,77,41
2,0,0,0,3,29,202,173
2,0,2,0,5,70,101,31
3,0,5,3,3,15,32,17
3,0,3,0,3,7,31,24
3,0,1,0,3,70,62,-8
3,0,2,1,5,310,10,-300
3,0,2,1,5,30,60,30
3,0,1,2,3,30,15,-15
3,0,1,0,3,2,55,53
3,0,0,0,3,128,20,-108
3,1,1,1,3,21,53,32
1,0,2,7,5,46,3,-43
1,0,0,0,3,82,54,-28
3,1,0,0,3,246,86,-160
1,0,4,0,3,47,183,136
3,0,5,1,3,58,24,-34
3,0,4,0,3,108,1071,963
3,0,5,4,3,22,1,-21
3,1,6,1,3,49,11,-38
3,0,3,7,3,164,81,-83
1,0,2,1,5,12,51,39
3,0,1,0,3,38,107,69
2,0,1,0,3,54,114,60
3,0,1,0,3,23,36,13
1,0,3,0,3,133,103,-30
3,0,5,1,3,21,58,37
2,0,1,1,3,26,19,-7
0,1,4,0,3,50,7,-43
3,0,2,3,5,73,13,-60
2,0,3,1,3,15,193,178
3,0,0,1,3,83,43,-40
1,0,2,2,5,15,107,92
2,0,2,3,5,50,29,-21
2,0,0,6,3,4,10,6
3,0,1,0,3,17,82,65
3,0,2,0,5,8,222,214
3,0,6,0,3,63,67,4
1,0,3,6,3,72,84,12
3,0,0,1,3,56,19,-37
3,0,0,4,3,47,38,-9
3,1,0,1,3,19,87,68
3,0,1,1,3,43,168,125
0,1,3,1,3,57,7,-50
1,0,6,2,3,249,97,-152
3,0,4,0,3,142,53,-89
3,0,6,0,3,101,110,9
2,0,2,2,5,39,12,-27
3,0,5,0,3,25,157,132
3,0,2,0,5,102,43,-59
3,0,2,0,5,57,219,162
3,0,0,1,3,50,122,72
1,0,2,2,5,114,8,-106
1,0,0,0,3,122,226,104
3,0,2,0,5,33,231,198
3,0,5,0,3,36,1,-35
3,0,6,2,3,16,25,9
3,0,0,1,3,18,31,13
3,1,0,4,3,23,4,-19
3,0,6,7,3,8,16,8
1,0,4,0,3,357,105,-252
3,0,1,6,3,13,7,-6
3,0,0,1,3,59,133,74
3,0,3,7,3,24,5,-19
2,0,2,0,5,120,48,-72
3,0,4,0,3,71,229,158
1,0,2,0,5,76,79,3
3,0,2,7,5,4,1,-3
3,0,0,4,3,64,48,-16
3,1,0,0,3,42,120,78
1,0,6,2,3,9,59,50
1,0,5,0,3,14,25,11
3,1,0,0,3,107,84,-23
3,0,0,1,3,30,92,62
1,0,0,0,3,66,118,52
1,0,3,1,3,73,20,-53
3,1,4,0,3,995,211,-784
1,0,3,0,3,78,259,181
1,0,3,0,3,50,68,18
1,0,5,0,3,47,65,18
3,0,6,0,3,81,54,-27
1,0,3,0,3,41,76,35
2,0,2,4,5,1,18,17
3,0,2,2,5,11,18,7
3,0,6,1,3,36,739,703
3,0,0,1,3,104,42,-62
1,0,0,0,3,107,238,131
2,0,2,0,5,47,28,-19
3,0,6,1,3,16,119,103
0,1,3,1,3,27,34,7
3,0,1,0,3,17,54,37
3,0,2,1,5,50,23,-27
1,0,5,0,3,5,55,50
1,0,2,0,5,84,79,-5
1,0,4,1,3,57,31,-26
3,0,2,3,5,192,4,-188
1,0,4,1,3,33,59,26
3,0,3,0,3,34,46,12
1,0,4,0,3,284,56,-228
1,0,6,4,3,1,6,5
3,1,0,0,3,84,139,55
2,0,3,4,3,77,2,-75
1,0,3,0,3,135,58,-77
3,0,3,0,3,528,145,-383
1,0,6,0,3,59,46,-13
3,1,3,6,3,49,103,54
2,0,2,0,5,45,86,41
3,0,2,2,5,3,151,148
1,0,3,6,3,31,18,-13
1,0,0,1,3,39,375,336
3,0,2,2,5,32,39,7
3,0,6,0,3,639,295,-344
3,0,6,0,3,43,53,10
3,0,2,1,5,84,5,-79
3,1,3,0,3,97,321,224
2,0,2,1,5,67,4,-63
3,1,0,1,3,84,33,-51
1,0,0,1,3,67,107,40
3,0,1,4,3,85,46,-39
1,0,0,4,3,104,533,429
2,0,0,1,3,87,95,8
3,0,6,2,3,23,89,66
3,0,2,2,5,19,130,111
3,0,6,0,3,62,15,-47
2,0,2,0,5,220,62,-158
3,0,0,1,3,57,95,38
1,0,2,0,5,57,63,6
3,0,0,1,3,45,59,14
3,0,2,1,5,95,27,-68
1,0,3,0,3,21,113,92
3,1,3,6,3,239,42,-197
3,1,0,0,3,34,48,14
1,0,0,0,3,165,126,-39
3,0,3,0,3,77,59,-18
1,0,0,0,3,81,45,-36
3,0,3,1,3,94,175,81
1,0,0,0,3,214,36,-178
1,0,6,0,3,30,20,-10
0,1,3,0,3,199,26,-173
3,0,0,1,3,195,36,-159
1,0,5,2,3,22,40,18
3,0,6,0,3,69,44,-25
3,0,3,0,3,40,89,49
3,0,0,6,3,10,1,-9
2,0,0,4,3,41,38,-3
2,0,2,0,5,102,57,-45
1,0,3,0,3,120,147,27
1,0,0,0,3,126,30,-96
1,0,2,1,5,79,160,81
1,0,0,1,3,73,124,51
3,0,4,4,3,57,50,-7
3,0,1,1,3,37,9,-28
1,0,0,1,3,10,53,43
3,1,4,4,3,13,20,7
1,0,6,1,3,33,25,-8
3,0,1,1,3,36,113,77
2,0,2,0,5,41,83,42
1,0,0,4,3,106,22,-84
3,0,6,4,3,1,20,19
3,0,1,4,3,9,1,-8
3,0,2,3,5,29,7,-22
3,1,4,4,3,15,1,-14
3,1,0,0,3,51,53,2
3,1,4,4,3,86,31,-55
2,0,1,0,3,106,487,381
1,0,0,1,3,56,95,39
3,0,2,0,5,91,46,-45
2,0,2,0,5,109,128,19
1,0,3,0,3,96,47,-49
3,0,5,0,3,48,227,179
3,0,6,0,3,39,55,16
3,0,3,1,3,45,94,49
1,0,0,4,3,59,104,45
1,0,2,1,5,42,33,-9
3,1,4,0,3,60,47,-13
3,1,0,0,3,101,373,272
3,0,3,7,3,66,39,-27
1,0,3,0,3,27,74,47
1,0,6,1,3,23,37,14
1,0,3,7,3,49,2,-47
3,0,1,2,3,37,323,286
3,0,2,0,5,60,38,-22
3,0,6,2,3,34,9,-25
3,1,3,0,3,446,76,-370
1,0,3,1,3,13,58,45
2,0,3,1,3,7,79,72
1,0,2,1,5,34,163,129
1,0,0,0,3,56,43,-13
1,0,3,0,3,47,306,259
3,1,0,0,3,71,98,27
1,1,0,1,3,98,18,-80
1,0,3,6,3,61,51,-10
3,0,5,1,3,443,14,-429
2,0,0,6,3,52,32,-20
1,0,5,2,3,8,15,7
1,0,0,0,3,102,84,-18
1,0,5,0,3,92,13,-79
1,0,6,1,3,29,15,-14
2,0,0,4,3,69,97,28
3,1,0,4,3,15,56,41
3,0,1,4,3,28,7,-21
3,0,6,0,3,80,87,7
3,1,5,2,3,53,15,-38
3,1,0,4,3,67,490,423
1,0,0,6,3,23,15,-8
3,0,6,0,3,36,40,4
3,0,6,0,3,33,31,-2
3,0,0,0,3,63,69,6
3,0,6,4,3,5,12,7
3,0,2,0,5,83,38,-45
1,0,6,0,3,47,64,17
3,0,6,1,3,45,16,-29
3,0,3,4,3,108,11,-97
3,0,4,1,3,663,57,-606
3,0,6,3,3,34,26,-8
1,0,4,0,3,79,55,-24
1,1,0,0,3,161,49,-112
3,0,3,0,3,238,158,-80
3,1,1,0,3,57,29,-28
3,0,3,4,3,23,68,45
3,0,1,6,3,57,24,-33
2,0,1,0,3,16,30,14
3,0,6,0,3,48,11,-37
1,0,3,0,3,99,75,-24
3,0,1,0,3,78,22,-56
1,0,4,0,3,58,187,129
3,0,2,0,5,2,97,95
2,0,2,1,5,50,8,-42
3,0,2,0,5,57,36,-21
2,0,2,0,5,80,92,12
3,1,0,4,3,119,8,-111
1,0,2,1,5,102,20,-82
3,1,3,0,3,82,117,35
1,0,0,1,3,49,265,216
3,1,0,0,3,222,109,-113
3,0,2,0,5,190,96,-94
1,0,1,1,3,101,40,-61
3,1,3,0,3,98,83,-15
1,0,0,0,3,108,52,-56
3,0,1,1,3,29,200,171
3,0,0,0,3,117,68,-49
3,0,6,1,3,55,28,-27
3,0,3,0,3,479,149,-330
2,0,1,1,3,22,27,5
3,0,3,1,3,23,135,112
2,0,2,1,5,156,50,-106
3,0,0,4,3,107,495,388
3,1,0,0,3,46,76,30
3,1,0,0,3,407,180,-227
1,0,3,0,3,288,85,-203
1,0,0,1,3,85,45,-40
1,0,4,1,3,17,86,69
3,0,2,0,5,24,112,88
1,0,2,0,5,51,83,32
1,0,1,1,3,123,4,-119
1,0,3,4,3,68,54,-14
2,0,0,0,3,87,53,-34
2,0,2,0,5,42,38,-4
3,1,0,4,3,13,50,37
3,0,0,4,3,22,14,-8
2,0,2,0,5,113,60,-53
1,0,1,1,3,126,8,-118
1,0,2,3,5,5,20,15
1,0,2,0,5,14,62,48
3,1,0,0,3,72,661,589
3,0,0,0,3,27,96,69
2,0,2,0,5,238,32,-206
2,0,3,1,3,64,118,54
1,0,6,0,3,177,16,-161
3,0,2,0,5,67,24,-43
1,0,0,7,3,87,21,-66
1,0,0,0,3,67,135,68
3,0,3,1,3,11,87,76
3,1,0,1,3,46,81,35
1,0,3,1,3,109,17,-92
3,0,0,0,3,123,73,-50
3,1,0,0,3,119,145,26
1,0,5,0,3,17,26,9
1,0,0,0,3,65,84,19
3,0,0,1,3,58,45,-13
1,0,0,1,3,106,146,40
1,0,6,4,3,5,1,-4
1,0,5,0,3,16,139,123
2,0,3,0,3,70,90,20
3,1,1,1,3,9,33,24
3,0,6,1,3,7,70,63
1,0,1,2,3,140,5,-135
3,0,3,4,3,45,43,-2
3,1,1,0,3,14,37,23
0,1,3,0,3,674,13,-661
1,0,4,0,3,127,67,-60
3,1,6,1,3,74,50,-24
3,1,0,0,3,75,64,-11
3,0,5,0,3,181,4,-177
3,1,0,0,3,197,66,-131
3,0,2,0,5,27,106,79
3,0,6,1,3,51,4,-47
3,0,3,1,3,84,12,-72
3,0,2,2,5,170,2,-168
3,0,3,1,3,32,1,-31
3,0,2,0,5,212,7,-205
3,0,3,0,3,90,54,-36
3,0,2,0,5,100,69,-31
3,0,6,1,3,25,47,22
1,0,0,0,3,110,68,-42
3,0,4,1,3,22,5,-17
1,0,3,7,3,47,75,28
1,0,0,6,3,62,42,-20
1,0,0,0,3,41,61,20
1,0,6,0,3,30,164,134
1,0,2,2,5,63,21,-42
3,0,4,0,3,80,71,-9
3,1,0,0,3,66,79,13
3,1,6,1,3,20,176,156
1,0,0,6,3,40,5,-35
3,0,6,0,3,74,125,51
3,0,5,0,3,1223,135,-1088
0,1,3,0,3,65,76,11
3,0,1,6,3,2,8,6
3,0,2,0,5,14,145,131
3,1,6,4,3,8,1,-7
3,1,0,1,3,9,45,36
2,0,1,0,3,35,38,3
2,0,3,1,3,62,112,50
3,0,1,1,3,16,113,97
0,1,5,0,3,37,45,8
3,0,3,2,3,64,164,100
1,0,2,0,5,119,3,-116
2,0,2,0,5,58,2,-56
1,0,3,0,3,305,92,-213
1,0,4,1,3,13,357,344
1,0,1,0,3,121,64,-57
3,0,5,2,3,32,3,-29
3,1,0,4,3,264,49,-215
1,0,0,1,3,14,98,84
1,0,2,2,5,103,4,-99
3,0,6,2,3,576,43,-533
1,0,0,0,3,260,240,-20
3,1,1,4,3,13,73,60
1,0,3,0,3,74,558,484
1,0,6,0,3,76,46,-30
3,1,1,1,3,22,38,16
3,1,1,0,3,30,170,140
2,0,2,0,5,30,90,60
2,0,2,0,5,119,71,-48
1,0,2,2,5,75,3,-72
3,0,1,1,3,19,80,61
3,0,5,2,3,94,14,-80
3,0,0,1,3,28,6,-22
3,0,6,1,3,11,131,120
3,0,4,0,3,78,97,19
3,0,6,4,3,18,3,-15
2,0,3,6,3,166,96,-70
3,0,0,0,3,67,32,-35
3,1,1,7,3,2,15,13
2,0,2,2,5,2,44,42
1,0,4,1,3,84,67,-17
3,0,0,4,3,48,72,24
3,1,4,0,3,9,182,173
1,0,3,1,3,114,204,90
1,0,3,0,3,83,167,84
3,1,3,1,3,196,85,-111
2,0,2,0,5,895,92,-803
3,1,1,0,3,43,48,5
1,0,3,0,3,113,130,17
3,1,3,0,3,95,112,17
1,0,1,1,3,43,60,17
1,0,0,1,3,63,47,-16
3,0,0,0,3,73,60,-13
3,0,2,2,5,4,72,68
3,0,6,0,3,45,85,40
0,1,3,1,3,2,139,137
3,1,3,0,3,110,72,-38
1,0,0,0,3,99,54,-45
1,0,0,0,3,122,36,-86
1,0,0,0,3,58,75,17
3,0,1,0,3,61,39,-22
1,0,0,0,3,208,91,-117
2,0,2,1,5,96,28,-68
2,0,2,0,5,1,110,109
3,0,1,6,3,84,2,-82
1,0,5,2,3,43,15,-28
1,0,1,0,3,62,272,210
3,0,6,0,3,340,44,-296
3,0,1,0,3,41,26,-15
3,1,4,7,3,78,76,-2
1,0,0,0,3,54,118,64
3,0,6,1,3,52,10,-42
3,0,6,2,3,7,67,60
3,1,0,0,3,141,225,84
1,0,3,0,3,93,103,10
2,0,2,2,3,28,2,-26
2,0,2,0,5,105,39,-66
3,0,2,2,5,34,1,-33
1,0,6,1,3,1,44,43
3,0,6,1,3,34,59,25
1,0,1,2,3,57,7,-50
3,0,2,1,5,87,41,-46
3,1,1,0,3,146,152,6
3,0,1,0,3,143,31,-112
1,0,3,0,3,18,86,68
2,0,1,0,3,35,87,52
3,1,6,2,3,17,5,-12
3,1,4,0,3,280,61,-219
1,0,6,4,3,34,1,-33
1,0,0,4,3,72,66,-6
3,1,3,1,3,34,36,2
3,1,6,0,3,38,65,27
1,0,1,0,3,593,99,-494
2,0,2,0,5,31,39,8
3,0,6,3,3,34,51,17
3,0,0,1,3,185,4,-181
1,0,2,3,5,34,9,-25
3,0,2,2,5,11,23,12
1,0,6,0,3,115,39,-76
3,0,6,0,3,87,27,-60
3,0,5,0,3,66,89,23
3,0,2,1,5,54,11,-43
3,0,6,4,3,20,6,-14
3,0,6,2,3,30,60,30
3,0,4,2,3,60,1,-59
3,1,0,0,3,167,41,-126
3,0,3,0,3,81,93,12
3,0,2,0,5,82,53,-29
3,0,2,0,5,71,106,35
3,0,6,1,3,4,66,62
1,0,0,0,3,121,43,-78
3,0,5,2,3,20,11,-9
3,1,0,0,3,98,89,-9
2,0,2,0,5,45,89,44
3,0,6,3,3,25,90,65
2,0,0,0,3,145,133,-12
2,0,0,0,3,74,140,66
1,0,0,0,3,7,47,40
3,0,2,1,5,21,100,79
1,0,4,0,3,106,54,-52
3,0,2,0,5,56,108,52
3,0,5,0,3,129,67,-62
2,0,2,0,5,256,28,-228
3,1,6,6,3,8,18,10
3,0,2,0,5,16,214,198
3,0,6,1,3,28,96,68
1,0,5,4,3,16,67,51
1,0,0,4,3,155,19,-136
1,0,5,1,3,31,63,32
3,0,6,7,3,4,3,-1
1,0,0,4,3,38,18,-20
1,0,4,2,3,35,8,-27
1,0,3,0,3,85,6,-79
3,1,0,0,3,134,32,-102
3,0,2,2,5,20,14,-6
3,1,3,1,3,3,83,80
3,0,6,1,3,19,15,-4
1,0,4,4,3,27,18,-9
1,0,2,0,5,92,50,-42
2,0,2,1,5,122,9,-113
3,0,0,6,3,9,40,31
3,0,0,1,3,102,23,-79
1,0,2,1,5,36,59,23
1,0,2,1,5,43,33,-10
1,0,0,0,3,20,82,62
3,1,6,1,3,58,11,-47
3,0,0,6,3,12,9,-3
3,1,3,4,3,99,3,-96
3,1,0,0,3,42,126,84
3,1,7,6,3,7,12,5
1,0,0,4,3,21,126,105
3,1,0,1,3,45,6,-39
3,0,6,1,3,15,36,21
3,1,0,1,3,37,106,69
3,0,5,3,3,9,5,-4
3,0,3,0,3,81,97,16
3,0,3,0,3,80,315,235
3,0,1,1,3,60,20,-40
3,0,6,1,3,38,4,-34
1,0,0,4,3,45,17,-28
3,0,0,0,3,65,75,10
1,0,2,0,5,57,124,67
3,0,0,0,3,108,174,66
3,1,6,1,3,9,19,10
3,1,5,2,3,6,11,5
1,0,3,0,3,72,166,94
3,1,4,0,3,146,96,-50
1,0,3,4,3,49,62,13
3,0,2,3,5,82,5,-77
3,0,6,1,3,17,84,67
1,0,6,2,3,15,6,-9
3,1,0,4,3,34,37,3
1,0,6,6,3,9,8,-1
3,1,1,0,3,21,13,-8
0,1,5,4,3,13,12,-1
3,0,4,0,3,129,105,-24
3,0,5,0,3,124,102,-22
3,1,1,4,3,37,10,-27
3,0,2,3,5,44,12,-32
1,1,0,0,3,114,127,13
2,0,1,0,3,1062,87,-975
1,0,0,4,3,152,10,-142
0,1,3,4,3,150,78,-72
3,0,2,0,5,100,283,183
1,0,0,0,3,83,108,25
3,0,2,0,5,306,99,-207
3,1,0,1,3,109,81,-28
1,0,0,1,3,1,85,84
3,0,1,1,3,74,31,-43
1,0,0,1,3,150,122,-28
3,0,6,6,3,1,33,32
1,0,0,1,3,82,79,-3
3,1,3,1,3,55,65,10
2,0,0,1,3,71,106,35
3,1,4,0,3,2,121,119
2,0,0,1,3,19,108,89
3,0,5,0,3,152,65,-87
2,0,2,0,5,120,80,-40
1,0,3,0,3,45,187,142
1,1,0,0,3,81,78,-3
1,0,0,1,3,94,24,-70
3,0,2,1,5,48,126,78
1,0,3,0,3,83,78,-5
1,0,4,0,3,134,74,-60
2,0,2,0,5,86,91,5
1,0,2,0,5,176,131,-45
1,0,0,0,3,368,46,-322
3,0,6,7,3,2,5,3
3,0,5,1,3,25,26,1
3,1,3,0,3,44,92,48
1,0,6,0,3,27,51,24
3,0,0,1,3,12,50,38
3,1,6,1,3,6,21,15
3,0,0,6,3,30,29,-1
3,0,0,1,3,57,55,-2
3,0,3,6,3,41,9,-32
3,0,1,0,3,1139,111,-1028
1,0,1,1,3,31,80,49
1,0,5,4,3,6,26,20
3,0,6,1,3,82,27,-55
3,1,0,4,3,62,155,93
2,0,2,0,5,62,193,131
1,0,6,1,3,93,5,-88
2,0,0,0,3,70,80,10
3,1,0,0,3,48,188,140
3,0,0,0,3,78,28,-50
2,0,2,0,5,9,51,42
3,0,2,1,5,16,59,43
3,0,1,0,3,38,16,-22
3,1,6,0,3,35,28,-7
3,1,1,0,3,3,52,49
1,0,1,1,3,94,19,-75
1,0,1,1,3,18,50,32
2,0,3,0,3,279,197,-82
3,0,1,4,3,62,32,-30
3,1,0,1,3,37,57,20
3,0,2,0,5,48,170,122
3,1,4,0,3,55,44,-11
3,1,4,4,3,49,8,-41
3,0,0,0,3,110,46,-64
1,0,0,1,3,56,76,20
3,1,3,4,3,17,95,78
3,0,3,0,3,134,61,-73
1,0,6,0,3,33,79,46
2,0,0,0,3,29,86,57
3,1,4,4,3,102,85,-17
2,0,2,4,5,30,9,-21
0,1,3,0,3,65,26,-39
3,0,1,1,3,53,17,-36
3,0,6,0,3,23,78,55
1,0,4,1,3,11,105,94
3,1,1,0,3,66,12,-54
3,1,0,1,3,68,3,-65
1,0,4,4,3,33,89,56
1,0,5,0,3,10,45,35
1,0,3,0,3,77,109,32
1,0,6,1,3,6,45,39
3,0,0,7,3,93,63,-30
3,0,3,0,3,106,365,259
3,1,0,1,3,132,110,-22
2,0,3,1,3,155,38,-117
3,1,3,1,3,29,60,31
3,0,5,4,3,1,6,5
3,0,2,1,5,7,100,93
1,0,3,4,3,75,295,220
3,0,6,0,3,38,36,-2
3,0,2,0,5,130,85,-45
3,1,0,4,3,72,37,-35
3,0,2,0,5,182,19,-163
3,0,0,0,3,48,63,15
3,1,6,2,3,42,65,23
3,0,4,0,3,197,95,-102
3,0,0,1,3,128,83,-45
3,1,5,0,3,22,35,13
3,1,4,0,3,94,178,84
1,0,2,0,5,54,16,-38
0,1,3,1,3,29,23,-6
3,1,0,1,3,9,49,40
1,0,0,0,3,99,135,36
3,1,1,0,3,55,6,-49
3,1,4,0,3,77,41,-36
1,0,1,1,3,45,54,9
1,0,3,4,3,74,59,-15
3,0,2,2,5,20,61,41
1,0,1,1,3,36,37,1
1,0,3,1,3,105,21,-84
3,0,6,1,3,1,55,54
3,0,2,1,5,1,39,38
3,0,6,2,3,3,35,32
1,0,3,6,3,110,71,-39
2,0,0,0,3,18,103,85
1,0,2,3,5,19,1,-18
1,0,3,0,3,91,96,5
3,0,2,0,5,113,40,-73
3,0,4,1,3,82,57,-25
2,0,0,0,3,59,61,2
3,0,3,0,3,107,15,-92
1,0,0,1,3,28,114,86
1,0,1,0,3,66,63,-3
1,0,3,7,3,21,23,2
3,0,6,0,3,86,40,-46
1,0,0,0,3,70,74,4
3,0,6,1,3,121,25,-96
3,1,0,6,3,4,12,8
3,0,0,1,3,6,663,657
1,0,6,1,3,68,18,-50
2,0,1,0,3,177,60,-117
3,0,1,1,3,77,53,-24
3,0,2,0,5,93,49,-44
3,0,3,0,3,95,13,-82
3,1,6,0,3,23,73,50
1,0,0,0,3,83,59,-24
3,1,6,0,3,25,45,20
3,0,2,2,5,2,37,35
3,0,2,2,5,3,55,52
1,0,1,0,3,39,20,-19
3,0,2,0,5,74,85,11
3,0,5,4,3,43,8,-35
1,0,0,4,3,9,72,63
3,1,0,6,3,27,34,7
1,0,4,0,3,78,17,-61
2,0,1,4,3,34,50,16
1,0,3,1,3,65,146,81
3,0,6,2,3,70,15,-55
2,0,3,0,3,43,40,-3
3,0,2,1,5,35,3,-32
3,0,2,1,5,33,59,26
2,0,2,0,5,17,308,291
3,0,5,0,3,5,39,34
3,0,2,1,5,70,42,-28
3,0,3,0,3,62,144,82
2,0,3,0,3,124,194,70
1,0,0,1,3,123,79,-44
3,0,2,1,5,71,21,-50
1,0,0,0,3,72,69,-3
3,0,6,2,3,56,24,-32
3,0,6,1,3,62,30,-32
1,0,3,1,3,58,97,39
3,0,3,1,3,88,55,-33
1,0,3,4,3,62,42,-20
3,0,0,1,3,125,375,250
1,0,1,0,3,37,73,36
1,0,3,0,3,31,98,67
1,0,6,2,3,4,22,18
3,0,6,0,3,63,71,8
1,0,4,1,3,50,221,171
3,0,2,0,5,49,81,32
3,1,1,1,3,44,23,-21
1,0,2,0,5,187,83,-104
1,0,0,0,3,18,161,143
3,0,0,4,3,81,15,-66
2,0,0,4,3,19,81,62
3,0,2,0,5,44,65,21
3,0,6,2,3,60,2,-58
3,0,6,1,3,76,19,-57
1,0,6,1,3,50,7,-43
1,0,0,1,3,82,127,45
3,0,5,0,3,34,75,41
3,1,6,0,3,22,17,-5
2,0,2,1,5,47,116,69
3,0,3,0,3,18,47,29
3,0,5,6,3,2,10,8
3,1,3,0,3,173,92,-81
1,0,4,1,3,59,102,43
3,0,0,6,3,95,133,38
3,0,0,1,3,14,177,163
3,0,1,6,3,14,26,12
3,0,2,4,5,2,21,19
3,0,6,0,3,55,56,1
1,0,3,0,3,95,28,-67
3,0,0,6,3,56,52,-4
3,1,3,0,3,115,110,-5
3,0,5,0,3,21,51,30
3,0,0,1,3,14,146,132
3,1,0,1,3,82,35,-47
3,0,3,1,3,79,112,33
1,0,6,1,3,48,11,-37
1,0,0,1,3,63,147,84
3,0,0,0,3,95,38,-57
3,0,0,4,3,40,39,-1
3,0,6,0,3,54,41,-13
1,0,0,0,3,143,89,-54
3,1,0,0,3,10,70,60
3,0,6,2,3,94,9,-85
2,0,2,0,5,97,107,10
3,1,0,0,3,213,31,-182
1,0,3,1,3,169,155,-14
3,0,5,1,3,22,63,41
3,0,6,2,3,4,59,55
1,0,0,4,3,74,155,81
1,0,2,1,5,3,104,101
1,0,3,0,3,86,71,-15
1,0,4,1,3,25,86,61
3,0,5,4,3,3,7,4
1,0,0,0,3,77,121,44
2,0,1,1,3,71,14,-57
1,0,6,1,3,63,11,-52
3,1,1,0,3,364,43,-321
2,0,0,0,3,17,203,186
3,1,4,4,3,38,28,-10
3,0,6,0,3,77,55,-22
3,0,3,0,3,38,6,-32
3,1,0,1,3,139,24,-115
1,0,6,1,3,23,17,-6
1,1,0,7,3,38,182,144
3,0,6,1,3,42,10,-32
3,0,6,4,3,25,3,-22
3,0,6,4,3,31,16,-15
3,1,3,1,3,29,35,6
1,0,0,0,3,81,47,-34
1,0,5,1,3,55,180,125
3,0,0,0,3,169,95,-74
1,0,6,0,3,264,77,-187
2,0,1,0,3,75,46,-29
3,0,2,0,5,54,92,38
2,0,0,4,3,11,155,144
2,0,2,0,5,43,61,18
1,0,3,4,3,28,15,-13
1,0,0,0,3,76,81,5
3,0,0,6,3,47,14,-33
3,1,7,7,3,6,4,-2
1,0,6,2,3,12,8,-4
3,0,5,1,3,39,29,-10
1,0,0,0,3,50,72,22
3,1,1,0,3,153,12,-141
3,0,5,0,3,91,164,73
2,0,0,4,3,66,28,-38
3,1,3,0,3,114,63,-51
3,0,4,0,3,92,93,1
1,0,6,1,3,18,51,33
1,0,6,0,3,34,120,86
2,0,0,0,3,65,128,63
3,0,5,1,3,50,9,-41
3,0,6,0,3,187,629,442
3,0,3,0,3,854,485,-369
3,0,1,0,3,7,36,29
3,0,0,1,3,14,57,43
3,0,5,0,3,39,22,-17
3,0,0,0,3,60,97,37
1,0,4,0,3,208,185,-23
1,0,5,1,3,55,34,-21
1,0,6,0,3,33,25,-8
1,0,4,0,3,87,39,-48
3,0,3,0,3,32,11,-21
3,0,1,0,3,23,79,56
1,0,2,1,5,13,42,29
2,0,2,0,5,86,861,775
3,0,5,0,3,64,83,19
1,0,5,1,3,7,26,19
3,0,7,5,3,6,1,-5
3,0,3,1,3,28,140,112
1,0,1,0,3,19,56,37
1,0,4,0,3,129,121,-8
3,1,0,1,3,62,8,-54
3,0,6,2,3,15,46,31
3,1,0,6,3,16,32,16
1,0,0,0,3,80,26,-54
1,0,1,0,3,12,22,10
1,0,2,1,5,1,161,160
3,0,1,2,3,69,19,-50
3,1,3,0,3,93,67,-26
3,0,4,1,3,108,72,-36
3,0,2,1,5,3,72,69
3,0,1,1,3,12,99,87
3,0,1,1,3,56,4,-52
3,1,6,2,3,13,7,-6
3,0,0,0,3,104,57,-47
2,0,2,2,5,51,71,20
2,0,3,6,3,15,42,27
1,0,0,6,3,54,82,28
3,1,7,5,3,13,1,-12
3,0,1,0,3,31,215,184
3,0,5,0,3,44,116,72
3,0,4,1,3,12,144,132
3,0,6,2,3,15,2,-13
3,0,2,1,5,86,84,-2
3,0,2,1,5,39,8,-31
1,0,3,0,3,578,82,-496
1,0,3,1,3,118,31,-87
1,0,6,0,3,36,85,49
1,0,4,2,3,57,9,-48
3,0,2,3,5,4,53,49
3,0,6,0,3,12,279,267
1,0,3,1,3,88,31,-57
3,0,4,1,3,75,31,-44
3,1,0,0,3,101,88,-13
3,1,5,1,3,40,5,-35
1,0,2,1,5,87,16,-71
1,0,0,0,3,113,22,-91
3,0,0,0,3,67,62,-5
3,0,6,0,3,169,93,-76
3,1,4,0,3,43,39,-4
3,0,2,0,5,136,50,-86
3,0,2,1,5,58,27,-31
3,0,2,0,5,47,3,-44
3,1,0,4,3,41,15,-26
3,0,4,2,3,8,41,33
1,0,2,3,5,10,6,-4
1,0,5,0,3,25,76,51
1,0,5,6,3,14,7,-7
1,0,1,0,3,126,15,-111
3,0,0,1,3,13,146,133
1,0,2,7,5,1,2,1
1,0,0,0,3,64,19,-45
3,0,6,2,3,5,36,31
1,0,1,1,3,121,43,-78
3,1,0,7,3,17,33,16
3,0,2,0,5,35,155,120
3,1,6,1,3,23,15,-8
1,0,2,1,5,9,91,82
1,0,5,2,3,75,59,-16
3,0,1,0,3,41,53,12
3,0,0,0,3,32,299,267
3,0,6,0,3,175,66,-109
1,0,5,1,3,76,54,-22
3,0,6,1,3,100,8,-92
1,0,6,1,3,3,43,40
3,0,6,4,3,1,8,7
3,0,3,0,3,7,143,136
1,0,0,1,3,12,63,51
1,0,2,0,5,102,24,-78
3,0,3,0,3,65,146,81
3,1,1,0,3,38,66,28
3,0,2,1,5,64,132,68
2,0,1,0,3,7,27,20
1,0,0,4,3,5,52,47
3,0,2,2,5,55,41,-14
3,0,2,2,5,178,88,-90
3,1,1,1,3,13,64,51
3,1,4,1,3,10,60,50
1,0,0,4,3,120,36,-84
0,1,3,1,3,22,67,45
3,0,1,0,3,100,44,-56
3,0,3,4,3,27,14,-13
3,1,3,0,3,9,202,193
2,0,2,2,5,88,18,-70
3,1,0,7,3,16,13,-3
3,0,0,1,3,94,50,-44
3,0,6,0,3,158,46,-112
3,0,6,2,3,35,17,-18
1,0,0,0,3,62,40,-22
3,1,3,0,3,144,20,-124
1,0,1,1,3,93,66,-27
1,1,0,4,3,26,33,7
3,0,0,6,3,93,58,-35
1,0,3,1,3,105,97,-8
1,0,3,0,3,69,25,-44
1,0,3,0,3,32,79,47
2,0,1,0,3,17,101,84
3,1,0,6,3,103,54,-49
3,1,1,0,3,36,113,77
1,0,2,0,5,46,240,194
3,0,0,4,3,205,77,-128
3,0,3,0,3,7,176,169
3,0,2,4,5,58,97,39
3,0,6,0,3,52,129,77
3,0,3,4,3,204,15,-189
1,0,4,6,3,95,59,-36
3,1,6,7,3,2,27,25
1,0,3,1,3,105,12,-93
3,0,5,3,3,10,31,21
3,0,1,0,3,27,3,-24
3,0,1,1,3,42,103,61
3,0,1,0,3,47,3,-44
3,0,4,2,3,93,74,-19
1,0,3,0,3,88,420,332
1,0,6,0,3,30,589,559
3,0,5,0,3,100,740,640
3,0,6,1,3,6,86,80
3,0,6,2,3,22,39,17
1,0,6,1,3,25,8,-17
1,0,2,0,5,40,74,34
3,1,6,1,3,34,14,-20
3,0,6,1,3,18,38,20
1,0,3,0,3,97,13,-84
3,1,1,1,3,4,81,77
3,0,2,0,5,104,49,-55
2,0,3,1,3,52,24,-28
1,0,0,7,3,35,16,-19
3,1,0,0,3,443,57,-386
3,0,0,1,3,65,90,25
1,0,6,0,3,42,29,-13
3,0,2,3,5,9,11,2
2,0,0,4,3,27,21,-6
1,0,3,4,3,60,63,3
1,0,0,0,3,56,99,43
3,0,3,1,3,67,63,-4
3,1,0,0,3,67,144,77
3,0,0,0,3,102,43,-59
3,1,0,6,3,60,65,5
3,0,0,1,3,36,60,24
3,0,6,1,3,36,15,-21
3,1,3,6,3,46,113,67
1,0,4,4,3,8,50,42
3,0,6,1,3,100,19,-81
1,0,6,0,3,54,105,51
3,1,0,0,3,45,78,33
3,0,5,1,3,61,21,-40
3,0,3,0,3,76,60,-16
1,0,6,1,3,10,34,24
2,0,0,1,3,61,16,-45
3,0,6,2,3,8,47,39
3,0,2,0,5,74,4,-70
3,0,6,0,3,290,21,-269
3,0,3,1,3,90,43,-47
1,0,5,0,3,56,25,-31
3,1,6,0,3,23,18,-5
3,1,1,0,3,15,63,48
0,1,3,0,3,21,126,105
3,0,6,1,3,16,32,16
3,0,6,0,3,61,208,147
3,0,5,1,3,31,60,29
3,1,0,4,3,93,110,17
3,0,6,2,3,14,21,7
1,0,1,1,3,73,77,4
3,0,3,0,3,74,54,-20
3,0,6,1,3,29,4,-25
3,0,3,4,3,77,8,-69
3,1,3,4,3,21,72,51
2,0,2,3,5,7,26,19
3,0,6,1,3,29,9,-20
3,0,4,1,3,21,129,108
3,0,6,0,3,26,45,19
1,0,2,0,5,78,13,-65
3,0,6,0,3,64,42,-22
1,1,0,0,3,135,57,-78
3,0,3,0,3,39,71,32
3,0,6,3,3,4,17,13
2,0,2,1,5,849,15,-834
1,0,0,1,3,114,24,-90
2,0,0,6,3,4,136,132
1,0,2,0,5,95,11,-84
3,0,2,0,5,70,104,34
1,0,3,4,3,42,63,21
3,0,6,1,3,28,102,74
1,0,2,1,5,29,46,17
2,0,3,0,3,99,86,-13
1,0,0,1,3,90,25,-65
1,0,3,4,3,31,159,128
3,0,6,1,3,13,81,68
3,0,5,1,3,117,49,-68
3,1,3,0,3,66,203,137
3,0,4,1,3,97,89,-8
3,1,0,6,3,47,13,-34
3,0,3,4,3,3,59,56
1,0,1,0,3,75,47,-28
3,0,1,1,3,128,9,-119
3,0,6,1,3,48,6,-42
1,0,3,1,3,184,5,-179
3,1,3,0,3,1,125,124
1,0,1,0,3,43,189,146
2,0,2,0,5,34,117,83
1,0,3,0,3,38,133,95
2,0,3,2,3,62,77,15
3,0,6,2,3,18,7,-11
3,0,2,1,5,181,30,-151
2,0,0,6,3,10,61,51
3,1,4,7,5,10,3,-7
3,0,5,1,3,15,128,113
3,0,5,1,3,61,11,-50
1,0,6,1,3,5,37,32
1,0,5,0,3,38,40,2
1,0,0,6,3,74,4,-70
3,0,2,1,5,52,1,-51
3,0,2,0,5,111,41,-70
3,0,3,6,3,60,38,-22
3,0,5,0,3,47,12,-35
3,0,1,0,3,63,20,-43
2,0,2,0,5,114,98,-16
2,0,2,1,5,18,66,48
3,1,0,1,3,69,81,12
1,0,2,2,5,12,105,93
1,0,0,1,3,84,53,-31
3,0,0,0,3,48,59,11
1,0,3,6,3,366,31,-335
3,0,6,0,3,59,55,-4
3,0,1,0,3,25,905,880
3,0,6,0,3,61,70,9
1,0,3,0,3,296,61,-235
0,1,3,0,3,7,223,216
3,0,1,2,3,181,80,-101
3,0,3,4,3,24,30,6
3,0,4,0,3,28,20,-8
3,0,3,0,3,33,88,55
3,1,0,0,3,78,76,-2
3,1,7,5,3,2,4,2
3,0,6,1,3,79,27,-52
3,0,5,0,3,77,35,-42
1,0,5,0,3,74,28,-46
3,0,1,1,3,36,71,35
3,0,4,7,3,31,35,4
1,0,0,0,3,108,81,-27
3,0,0,4,3,4,60,56
3,0,1,1,3,63,36,-27
3,0,6,0,3,100,70,-30
1,0,3,0,3,4,103,99
1,0,3,0,3,58,10,-48
1,0,0,4,3,20,68,48
1,0,4,1,3,275,25,-250
3,1,0,0,3,81,43,-38
1,0,3,0,3,110,52,-58
3,0,3,0,3,119,171,52
3,1,3,1,3,22,109,87
3,0,0,1,3,6,88,82
3,0,6,1,3,62,14,-48
1,0,2,0,5,846,146,-700
3,0,0,1,3,141,139,-2
1,0,2,2,5,55,11,-44
1,0,2,0,5,54,24,-30
1,0,3,0,3,175,73,-102
1,0,5,1,3,33,164,131
3,0,0,0,3,53,67,14
1,0,5,0,3,83,53,-30
3,1,0,4,3,14,157,143
1,0,3,0,3,50,108,58
1,0,3,4,3,18,70,52
0,1,3,0,3,124,80,-44
3,0,3,1,3,62,24,-38
3,0,6,1,3,2,73,71
1,0,4,6,3,35,4,-31
1,0,3,6,3,37,73,36
1,0,6,1,3,26,3,-23
3,0,6,0,3,47,48,1
3,0,0,4,3,16,33,17
3,0,2,0,5,57,37,-20
3,1,3,1,3,59,22,-37
3,0,5,6,3,17,8,-9
3,0,6,1,3,9,50,41
1,0,4,0,3,473,120,-353
3,1,3,4,3,105,4,-101
3,0,1,0,3,74,25,-49
3,0,2,2,5,13,24,11
3,0,2,0,5,71,252,181
3,0,1,2,3,24,96,72
3,0,5,1,3,22,48,26
3,0,3,6,3,22,41,19
2,0,0,0,3,109,49,-60
3,0,6,1,3,26,111,85
1,0,2,0,5,51,120,69
1,0,4,1,3,42,56,14
3,1,0,6,3,8,74,66
1,0,5,0,3,73,24,-49
3,1,1,0,3,38,59,21
1,0,6,2,3,47,4,-43
0,1,5,2,3,50,19,-31
1,0,2,1,5,136,110,-26
3,0,5,1,3,58,26,-32
2,0,0,1,3,121,226,105
3,0,6,2,3,4,33,29
3,0,6,0,3,66,18,-48
1,0,0,4,3,93,179,86
1,0,3,0,3,77,93,16
3,0,6,1,3,31,5,-26
3,1,0,1,3,10,275,265
1,0,6,1,3,2,43,41
3,1,1,0,3,41,74,33
1,0,0,0,3,110,33,-77
3,0,1,6,3,32,6,-26
3,0,2,0,5,87,113,26
3,1,6,1,3,7,23,16
3,0,3,4,3,62,23,-39
2,0,2,0,5,128,145,17
1,0,0,0,3,131,105,-26
2,0,2,3,5,15,8,-7
3,1,3,0,3,23,97,74
0,1,3,1,3,47,26,-21
3,1,3,0,3,188,1291,1103
3,1,6,0,3,97,31,-66
3,0,6,2,3,34,6,-28
1,0,0,7,3,43,33,-10
1,0,3,6,3,51,41,-10
3,0,0,0,3,53,98,45
3,0,0,0,3,24,79,55
1,0,0,0,3,79,43,-36
3,0,5,4,3,17,26,9
1,0,2,2,5,11,48,37
3,0,3,0,3,64,65,1
3,0,2,0,5,47,33,-14
2,0,0,0,3,57,39,-18
1,0,4,1,3,71,61,-10
2,0,3,6,3,26,1,-25
3,0,6,0,3,48,142,94
1,0,5,2,3,23,3,-20
3,0,2,0,5,63,9,-54
3,0,2,2,5,10,46,36
1,0,3,0,3,58,80,22
3,0,2,4,5,5,18,13
3,0,5,6,3,26,8,-18
1,0,5,0,3,19,14,-5
3,0,4,1,3,30,101,71
3,0,0,2,3,44,17,-27
1,0,6,2,3,26,3,-23
0,1,3,0,3,44,62,18
3,0,3,0,3,113,21,-92
3,1,0,0,3,72,95,23
1,0,6,1,3,1,148,147
1,0,2,0,5,1,40,39
3,1,0,0,3,62,70,8
1,0,0,1,3,61,88,27
3,0,1,0,3,67,26,-41
1,0,2,0,5,9,49,40
1,0,6,0,3,51,60,9
2,0,2,0,5,135,112,-23
3,1,1,1,3,33,17,-16
1,0,0,1,3,182,51,-131
3,0,5,0,3,19,23,4
1,0,0,1,3,86,98,12
3,0,5,2,3,24,11,-13
1,0,1,0,3,111,69,-42
3,0,6,1,3,48,20,-28
3,0,6,0,3,68,533,465
3,0,6,4,3,8,37,29
3,0,5,0,3,56,36,-20
3,1,5,1,3,23,11,-12
3,1,5,4,3,1,47,46
3,1,0,0,3,55,88,33
3,0,0,1,3,51,47,-4
2,0,0,1,3,43,98,55
3,1,3,1,3,771,7,-764
3,0,6,0,3,95,13,-82
1,0,3,0,3,91,95,4
3,1,0,0,3,89,49,-40
1,0,0,1,3,14,84,70
2,0,0,0,3,82,96,14
3,0,6,0,3,53,119,66
1,0,0,1,3,2,57,55
2,0,3,6,3,54,127,73
3,0,0,0,3,106,55,-51
1,0,0,0,3,148,207,59
3,1,0,1,3,104,59,-45
1,0,0,1,3,81,72,-9
3,0,6,2,3,15,22,7
1,0,3,0,3,44,88,44
2,0,2,1,5,34,77,43
2,0,2,1,5,18,216,198
3,1,0,4,3,19,45,26
3,0,5,6,3,2,3,1
3,0,2,3,5,19,114,95
1,0,6,0,3,48,23,-25
1,0,3,0,3,70,51,-19
1,0,3,0,3,69,17,-52
1,0,0,0,3,128,94,-34
2,0,2,0,5,2,88,86
1,0,3,0,3,86,97,11
3,1,0,6,3,12,9,-3
1,0,2,0,5,86,19,-67
0,1,3,0,3,52,466,414
1,0,3,0,3,81,100,19
3,0,3,6,3,9,93,84
1,0,2,1,5,72,33,-39
2,0,3,0,3,171,79,-92
1,0,0,4,3,152,2,-150
3,0,3,6,3,38,30,-8
3,1,0,4,3,12,52,40
1,0,0,0,3,289,67,-222
3,0,6,3,3,9,13,4
3,0,5,3,3,2,22,20
3,1,0,0,3,139,277,138
3,0,0,6,3,9,52,43
3,0,6,1,3,13,46,33
3,0,0,6,3,66,33,-33
3,0,5,0,3,103,50,-53
1,0,0,6,3,80,5,-75
3,0,5,0,3,88,112,24
3,0,2,1,5,13,145,132
3,1,3,0,3,74,78,4
3,0,1,0,3,30,22,-8
1,0,3,0,3,84,49,-35
3,1,0,1,3,12,78,66
2,0,3,1,3,277,92,-185
3,0,0,0,3,61,95,34
3,0,2,1,5,107,28,-79
3,1,3,0,3,184,137,-47
3,1,0,0,3,109,53,-56
1,0,4,1,3,28,63,35
3,0,3,1,3,2,149,147
3,0,0,0,3,81,91,10
3,0,6,1,3,14,57,43
0,1,3,1,3,31,395,364
2,0,3,1,3,163,6,-157
3,0,2,0,5,22,69,47
3,0,2,2,5,44,14,-30
1,0,0,0,3,52,60,8
1,0,0,1,3,74,77,3
3,0,0,0,3,361,98,-263
3,0,6,2,3,9,34,25
1,0,0,1,3,267,139,-128
3,1,1,0,3,34,16,-18
1,0,0,4,3,75,4,-71
1,0,6,0,3,93,13,-80
1,0,6,1,3,16,36,20
1,0,6,2,3,24,5,-19
3,0,0,0,3,41,72,31
1,0,0,4,3,19,147,128
3,0,0,0,3,54,37,-17
3,0,4,0,3,102,96,-6
1,1,0,1,3,57,110,53
1,0,3,0,3,20,102,82
1,0,0,0,3,36,82,46
3,0,3,1,3,26,58,32
3,0,6,0,3,85,179,94
1,0,0,4,3,36,71,35
1,0,0,6,3,54,67,13
1,0,3,6,3,60,72,12
1,1,0,0,3,92,125,33
1,0,3,4,3,3,28,25
1,0,6,1,3,12,22,10
1,0,1,0,3,51,92,41
1,0,1,0,3,91,68,-23
1,0,1,0,3,67,50,-17
3,0,4,1,3,46,39,-7
3,0,6,2,3,33,35,2
3,0,2,1,5,70,33,-37
1,0,2,2,5,26,10,-16
1,0,0,1,3,10,188,178
1,0,6,1,3,32,10,-22
3,0,6,2,3,34,6,-28
3,1,1,4,3,6,22,16
1,0,0,4,3,96,1,-95
3,0,6,1,3,47,12,-35
2,0,1,4,3,13,44,31
2,0,2,1,5,144,14,-130
1,0,2,1,5,4,220,216
3,0,5,0,3,104,35,-69
3,0,0,0,3,61,64,3
3,1,0,1,3,43,107,64
1,0,3,1,3,190,30,-160
2,0,1,0,3,10,62,52
1,0,6,0,3,60,43,-17
1,0,0,1,3,47,24,-23
3,1,6,4,3,12,2,-10
0,1,3,0,3,11,14,3
2,0,2,1,5,87,136,49
2,0,1,1,3,71,30,-41
1,0,0,1,3,124,199,75
3,0,3,5,3,73,102,29
1,0,2,1,5,74,24,-50
3,0,6,1,3,560,29,-531
3,0,0,0,3,120,233,113
1,0,2,0,5,50,7,-43
1,0,3,0,3,56,48,-8
3,0,4,0,3,147,86,-61
3,0,2,1,5,72,66,-6
3,1,1,1,3,12,19,7
1,0,5,0,3,23,4,-19
1,0,3,1,3,80,18,-62
2,0,0,4,3,211,98,-113
1,0,4,1,3,18,63,45
3,1,6,7,3,10,1,-9
1,0,2,0,5,71,123,52
2,0,0,6,3,31,42,11
1,0,2,0,5,33,112,79
3,0,3,1,3,25,69,44
3,0,3,6,3,3,1,-2
1,0,1,4,3,7,18,11
3,1,0,0,3,6,368,362
3,0,6,1,3,16,38,22
3,0,0,0,3,52,79,27
1,0,3,0,3,92,374,282
2,0,2,0,5,81,122,41
3,1,0,1,3,54,9,-45
1,0,0,1,3,65,42,-23
3,0,6,3,3,5,79,74
1,0,5,0,3,93,61,-32
3,0,3,1,3,80,165,85
3,0,0,0,3,137,128,-9
3,1,0,7,3,129,93,-36
3,0,5,1,3,3,82,79
1,0,0,4,3,119,18,-101
3,0,0,1,3,95,18,-77
1,0,3,1,3,94,75,-19
3,1,1,0,3,34,5,-29
1,0,6,4,3,6,24,18
1,0,6,1,3,60,5,-55
3,0,3,7,3,50,14,-36
3,0,5,0,3,54,53,-1
3,1,1,0,3,90,52,-38
3,0,3,1,3,38,117,79
1,0,0,0,3,83,152,69
3,0,2,0,5,1370,1,-1369
1,0,0,0,3,482,22,-460
3,0,4,1,3,51,20,-31
2,0,1,0,3,67,16,-51
3,0,1,0,3,41,10,-31
3,0,0,1,3,50,44,-6
1,0,0,1,3,116,128,12
3,0,2,0,5,5,67,62
1,0,1,0,3,52,100,48
1,0,6,0,3,44,50,6
1,0,6,1,3,12,31,19
1,0,3,1,3,3,81,78
1,0,2,0,5,94,20,-74
1,0,6,0,3,58,43,-15
3,0,6,0,3,58,50,-8
3,0,1,1,3,39,9,-30
1,0,0,1,3,80,11,-69
3,0,4,1,3,80,204,124
3,0,4,2,3,14,434,420
2,0,0,1,3,39,93,54
3,0,0,1,3,11,141,130
3,0,4,0,3,66,258,192
3,0,4,1,3,116,37,-79
1,0,5,2,3,5,28,23
1,0,0,0,3,156,145,-11
3,0,6,0,3,45,57,12
2,0,2,1,5,94,23,-71
1,0,3,0,3,31,65,34
1,0,0,0,3,110,44,-66
2,0,2,0,5,163,26,-137
1,0,0,1,3,43,70,27
1,0,5,2,3,37,29,-8
3,0,0,0,3,107,612,505
1,0,3,0,3,51,58,7
3,1,6,1,3,60,12,-48
3,0,1,4,3,29,17,-12
1,0,3,4,3,59,67,8
3,1,1,0,3,54,135,81
3,0,3,0,3,34,5,-29
3,0,1,0,3,43,64,21
3,0,2,1,5,61,6,-55
3,0,0,4,3,38,31,-7
3,0,5,0,3,87,60,-27
1,0,0,4,3,140,40,-100
2,0,3,2,3,8,20,12
1,0,4,0,3,69,112,43
1,0,0,6,3,241,95,-146
3,1,3,4,3,160,90,-70
3,0,6,2,3,34,101,67
3,0,1,7,3,7,49,42
3,0,5,1,3,9,71,62
3,1,3,0,3,68,366,298
3,0,6,1,3,69,25,-44
3,0,3,1,3,58,49,-9
1,0,0,1,3,98,28,-70
3,1,1,0,3,103,50,-53
3,1,0,1,3,55,12,-43
2,0,0,1,3,159,39,-120
2,0,2,4,5,40,43,3
1,0,4,1,3,36,82,46
1,0,1,1,3,31,120,89
3,0,6,1,3,51,3,-48
3,0,0,7,3,36,173,137
1,0,5,1,3,58,40,-18
3,1,4,4,3,41,43,2
1,0,6,0,3,22,46,24
3,0,2,1,5,9,53,44
0,1,3,4,3,10,47,37
3,1,1,0,3,38,24,-14
3,0,2,1,5,245,145,-100
1,0,1,1,3,25,95,70
3,0,4,0,3,60,436,376
2,0,2,2,5,8,55,47
1,0,4,1,3,114,16,-98
1,0,0,0,3,64,319,255
3,0,6,1,3,21,71,50
3,0,0,2,3,54,30,-24
2,0,0,0,3,37,116,79
3,1,3,4,3,73,139,66
1,0,6,1,3,15,54,39
1,0,1,0,3,429,91,-338
1,0,6,4,3,3,36,33
3,0,2,0,5,22,39,17
3,0,2,2,5,11,57,46
3,1,0,0,3,44,107,63
1,0,5,1,3,8,65,57
1,0,3,2,3,69,46,-23
3,0,2,0,5,111,1,-110
3,1,3,1,3,20,65,45
1,0,0,0,3,168,826,658
0,1,3,0,3,76,175,99
1,0,0,1,3,148,76,-72
3,1,0,4,3,344,70,-274
3,0,1,2,3,8,37,29
3,0,1,0,3,80,132,52
3,1,0,0,3,14,107,93
3,0,2,2,5,23,14,-9
2,0,1,0,3,47,35,-12
0,1,3,1,3,18,68,50
1,0,6,0,3,41,48,7
1,0,6,7,3,3,7,4
2,0,0,0,3,57,45,-12
1,0,3,0,3,20,298,278
1,0,5,1,3,177,23,-154
1,0,6,0,3,105,18,-87
1,0,4,0,3,105,356,251
3,0,6,0,3,54,128,74
3,0,2,0,5,36,32,-4
2,0,2,0,5,72,31,-41
1,0,2,2,5,13,48,35
3,1,7,5,3,6,3,-3
1,0,2,1,5,89,70,-19
1,0,1,0,3,10,374,364
1,0,3,4,3,68,146,78
1,0,0,0,3,232,259,27
3,0,6,0,3,43,61,18
3,1,3,0,3,12,48,36
2,0,1,0,3,60,92,32
3,0,2,3,5,15,3,-12
3,0,2,0,5,70,108,38
3,0,5,2,3,77,22,-55
3,0,6,1,3,13,76,63
3,1,0,1,3,149,44,-105
1,0,0,0,3,47,543,496
3,0,2,0,5,9,191,182
1,0,2,0,5,54,142,88
3,0,6,2,3,113,15,-98
2,0,2,1,5,154,34,-120
1,0,4,1,3,33,184,151
3,0,5,0,3,989,41,-948
3,1,4,0,3,142,116,-26
2,0,3,0,3,42,118,76
3,0,2,0,5,38,1,-37
3,0,2,6,5,4,26,22
1,0,5,2,3,9,70,61
3,0,0,0,3,96,62,-34
1,0,1,1,3,6,72,66
1,0,0,1,3,48,77,29
3,0,2,2,5,9,74,65
1,0,0,1,3,73,95,22
3,1,1,0,3,46,57,11
1,0,2,0,5,201,14,-187
3,1,1,4,3,11,12,1
2,0,0,0,3,77,284,207
3,0,2,1,5,74,31,-43
1,0,0,0,3,33,66,33
3,0,5,0,3,56,60,4
3,0,0,1,3,97,34,-63
1,0,2,2,5,1,46,45
3,0,2,0,5,19,185,166
3,0,3,0,3,82,38,-44
3,0,4,7,3,28,55,27
3,0,6,0,3,34,16,-18
3,1,4,0,3,42,23,-19
3,0,2,1,5,85,27,-58
1,0,0,0,3,127,109,-18
2,0,0,1,3,27,45,18
1,0,6,2,3,65,1,-64
2,0,2,0,5,46,24,-22
3,1,0,4,3,41,10,-31
3,0,6,2,3,3,31,28
1,0,0,0,3,34,81,47
3,0,0,0,3,49,184,135
3,0,0,1,3,67,58,-9
3,1,0,4,3,8,17,9
1,0,3,1,3,66,46,-20
3,0,0,2,3,76,49,-27
1,0,3,1,3,38,8,-30
1,0,1,0,3,829,78,-751
1,0,3,0,3,130,28,-102
1,0,0,4,3,74,73,-1
3,0,3,0,3,44,29,-15
3,0,3,1,3,63,144,81
3,0,6,6,3,7,4,-3
1,0,0,0,3,47,457,410
2,0,0,4,3,116,298,182
3,0,0,4,3,19,84,65
3,0,2,0,5,106,31,-75
1,0,1,1,3,34,60,26
1,0,4,4,3,130,65,-65
1,0,4,1,3,22,193,171
3,0,4,6,3,5,42,37
1,0,2,0,5,94,35,-59
1,0,0,0,3,56,184,128
1,0,3,6,3,133,75,-58
3,0,5,6,3,22,9,-13
3,1,6,2,3,6,23,17
3,1,6,1,3,18,10,-8
3,0,5,1,3,20,72,52
3,1,1,0,3,78,61,-17
1,0,3,5,3,62,113,51
3,0,3,0,3,59,69,10
1,0,3,0,3,57,100,43
3,0,2,1,5,124,6,-118
2,0,2,0,5,8,207,199
3,1,0,0,3,66,125,59
3,0,6,0,3,60,101,41
1,0,0,0,3,259,28,-231
2,0,2,0,5,50,75,25
3,0,0,0,3,590,87,-503
1,0,2,3,5,30,59,29
3,0,0,1,3,54,434,380
3,1,0,4,3,21,60,39
3,0,0,1,3,45,58,13
1,0,6,6,3,4,7,3
3,0,6,2,3,57,45,-12
3,1,3,1,3,75,9,-66
3,0,5,2,3,22,35,13
3,0,2,0,5,41,40,-1
3,0,1,1,3,14,39,25
3,0,1,1,3,59,19,-40
3,0,6,0,3,9,34,25
1,0,0,0,3,212,57,-155
3,0,6,0,3,77,58,-19
3,1,3,1,3,97,131,34
3,1,6,1,3,1,34,33
3,0,1,1,3,15,123,108
2,0,0,4,3,67,11,-56
3,1,1,0,3,133,171,38
2,0,0,0,3,146,116,-30
1,0,0,0,3,50,88,38
3,1,1,0,3,22,16,-6
3,1,1,0,3,49,17,-32
3,0,5,3,3,2,17,15
3,0,2,0,5,121,52,-69
3,0,2,0,5,105,155,50
2,0,0,0,3,52,76,24
3,0,2,1,5,168,6,-162
1,0,3,4,3,57,107,50
3,1,0,0,3,304,34,-270
1,0,1,4,3,104,7,-97
1,0,3,0,3,141,86,-55
3,0,0,0,3,232,117,-115
3,0,0,4,3,24,29,5
3,0,6,1,3,420,7,-413
3,1,6,6,3,14,2,-12
1,0,0,0,3,17,65,48
1,0,3,0,3,494,107,-387
1,0,3,0,3,49,99,50
1,0,4,0,3,178,1008,830
1,0,0,4,3,40,24,-16
3,0,2,1,5,29,139,110
1,0,5,0,3,115,20,-95
3,0,1,7,3,123,7,-116
1,0,2,0,5,34,73,39
3,1,0,0,3,115,65,-50
3,0,0,0,3,83,31,-52
1,0,0,4,3,103,89,-14
3,1,0,0,3,93,43,-50
2,0,2,1,5,142,160,18
3,1,1,1,3,47,8,-39
3,0,6,0,3,56,37,-19
1,0,3,0,3,163,108,-55
1,0,1,0,3,46,207,161
3,1,0,0,3,32,92,60
3,0,0,0,3,316,126,-190
3,1,0,0,3,38,318,280
1,0,2,2,5,1,227,226
3,1,0,4,3,213,26,-187
1,0,4,1,3,131,18,-113
3,0,1,0,3,38,88,50
3,1,1,1,3,22,69,47
3,0,2,0,5,22,81,59
3,0,3,0,3,66,64,-2
3,0,1,0,3,63,82,19
1,0,0,0,3,82,107,25
2,0,0,7,3,33,26,-7
3,0,1,0,3,10,43,33
1,0,0,0,3,862,54,-808
1,0,0,1,3,25,309,284
1,0,2,0,5,81,64,-17
1,0,0,0,3,280,89,-191
1,0,3,0,3,66,3,-63
3,0,3,1,3,67,102,35
3,0,1,0,3,257,20,-237
3,0,3,1,3,27,85,58
1,0,3,4,3,52,61,9
1,0,0,0,3,32,61,29
3,0,6,0,3,33,32,-1
3,0,0,1,3,14,91,77
1,0,3,1,3,25,144,119
3,0,4,2,3,116,6,-110
3,1,0,0,3,76,105,29
1,0,0,4,3,88,66,-22
1,1,0,1,3,142,149,7
3,0,0,1,3,46,29,-17
2,0,2,0,5,45,107,62
3,0,0,1,3,117,6,-111
3,0,6,0,3,92,93,1
3,0,5,1,3,25,104,79
1,0,6,1,3,73,10,-63
3,0,1,1,3,42,34,-8
1,0,0,1,3,212,39,-173
3,0,3,0,3,162,28,-134
3,0,4,0,3,96,114,18
1,0,3,1,3,85,145,60
3,0,4,0,3,36,50,14
3,1,0,0,3,91,69,-22
2,0,2,1,5,82,37,-45
2,0,1,1,3,13,553,540
3,0,2,2,5,38,6,-32
1,0,5,1,3,53,14,-39
3,0,3,6,3,5,59,54
3,0,3,1,3,38,55,17
3,0,6,2,3,23,11,-12
1,0,6,0,3,38,81,43
1,0,3,4,3,68,7,-61
0,1,3,4,3,106,25,-81
1,0,0,1,3,144,136,-8
3,0,2,0,5,83,31,-52
3,1,5,0,3,106,18,-88
1,0,2,0,5,19,85,66
3,1,0,1,3,29,35,6
1,0,3,1,3,93,98,5
2,0,2,0,5,174,30,-144
0,1,5,0,3,68,33,-35
2,0,2,0,5,59,79,20
3,0,2,4,5,6,34,28
3,0,6,0,3,60,39,-21
3,0,2,0,5,79,22,-57
3,1,4,1,3,57,25,-32
3,0,2,0,5,48,46,-2
3,0,1,6,3,72,9,-63
3,0,6,2,3,28,12,-16
1,0,2,0,5,90,97,7
3,0,2,2,5,19,89,70
1,0,1,0,3,192,16,-176
2,0,0,0,3,71,81,10
1,0,0,4,3,172,55,-117
3,1,6,0,3,57,41,-16
3,0,2,1,5,38,95,57
3,0,2,0,5,87,66,-21
3,0,0,4,3,157,19,-138
1,0,5,1,3,7,109,102
1,0,3,1,3,31,93,62
3,0,5,3,3,2,70,68
3,0,2,0,5,145,54,-91
3,0,0,0,3,59,95,36
2,0,3,0,3,74,27,-47
3,0,2,1,5,40,13,-27
3,0,0,4,3,50,24,-26
3,0,6,3,3,13,33,20
1,0,5,0,3,16,34,18
1,0,1,2,3,73,26,-47
3,0,1,4,3,16,5,-11
3,0,6,0,3,54,22,-32
1,0,6,4,3,18,7,-11
1,0,6,0,3,88,111,23
1,0,4,1,3,13,77,64
3,0,0,1,3,67,35,-32
3,1,0,6,3,37,14,-23
1,0,0,0,3,84,135,51
1,0,1,1,3,4,68,64
2,0,1,0,3,17,166,149
0,1,3,0,3,31,393,362
3,0,3,1,3,30,1,-29
1,0,0,4,3,87,79,-8
1,0,0,0,3,228,53,-175
1,0,0,0,3,321,145,-176
1,0,2,0,5,122,83,-39
3,1,5,2,3,7,19,12
3,0,2,0,5,17,87,70
3,0,5,0,3,39,82,43
3,1,3,0,3,698,53,-645
3,0,2,1,5,14,57,43
3,0,3,6,3,43,27,-16
1,0,3,2,3,11,68,57
3,0,5,1,3,5,117,112
3,0,3,4,3,4,34,30
3,0,1,7,3,1,3,2
3,0,1,1,3,76,25,-51
3,1,3,7,3,27,24,-3
3,0,2,0,5,11,91,80
3,0,6,0,3,73,70,-3
3,0,6,1,3,41,32,-9
1,0,3,1,3,137,17,-120
3,0,6,0,3,48,42,-6
3,0,3,0,3,150,133,-17
1,0,3,0,3,31,78,47
3,0,2,0,5,145,1,-144
2,0,3,4,3,111,25,-86
3,0,0,1,3,40,60,20
3,0,2,0,5,8,184,176
3,0,2,0,5,110,35,-75
2,0,3,4,3,8,34,26
3,0,2,0,5,17,220,203
1,0,3,1,3,8,63,55
1,0,5,4,3,55,4,-51
3,1,0,0,3,72,100,28
3,0,6,4,3,20,12,-8
3,1,6,4,3,1,5,4
3,0,0,0,3,82,90,8
1,0,0,0,3,33,78,45
3,0,6,0,3,29,38,9
3,0,1,1,3,233,9,-224
1,0,5,1,3,7,45,38
1,0,5,1,3,9,32,23
1,0,3,0,3,47,15,-32
3,0,3,4,3,20,65,45
3,0,6,0,3,106,30,-76
1,0,0,4,3,273,142,-131
1,0,2,0,5,85,113,28
1,0,0,0,3,124,150,26
1,0,0,0,3,55,99,44
3,0,3,6,3,1,28,27
1,0,1,4,3,13,16,3
3,0,2,0,5,34,293,259
3,0,3,0,3,130,28,-102
3,0,0,4,3,5,18,13
3,0,6,4,3,36,5,-31
3,1,3,0,3,312,102,-210
3,0,2,2,5,10,78,68
3,0,5,0,3,79,54,-25
3,0,0,0,3,980,66,-914
2,0,2,0,5,22,60,38
3,0,1,0,3,62,103,41
3,1,5,2,3,9,11,2
1,0,0,4,3,82,64,-18
3,1,0,7,3,10,93,83
1,1,0,1,3,166,67,-99
1,0,4,2,3,93,83,-10
3,0,1,2,3,44,18,-26
2,0,2,0,5,98,34,-64
2,0,2,0,5,219,40,-179
3,1,1,0,3,72,20,-52
1,0,2,0,5,120,85,-35
1,0,4,2,3,81,11,-70
3,0,5,1,3,2,33,31
3,1,0,0,3,115,117,2
1,0,6,0,3,18,59,41
2,0,0,2,3,105,24,-81
3,0,3,6,3,128,14,-114
1,0,4,0,3,54,41,-13
3,0,1,0,3,17,8,-9
3,0,5,0,3,31,560,529
1,0,0,1,3,46,213,167
3,1,3,0,3,99,43,-56
3,0,4,1,3,14,42,28
3,1,7,5,3,1,4,3
1,0,6,0,3,45,52,7
3,1,6,0,3,247,20,-227
3,0,2,1,5,21,136,115
3,0,3,2,3,112,65,-47
3,0,2,1,5,130,14,-116
3,1,0,1,3,7,124,117
3,1,0,0,3,189,259,70
3,0,3,0,3,47,99,52
1,0,0,0,3,62,85,23
1,0,6,2,3,7,35,28
3,0,2,0,5,34,109,75
2,0,3,0,3,163,50,-113
0,1,3,0,3,30,42,12
2,0,1,0,3,64,78,14
2,0,3,1,3,117,247,130
1,0,6,4,3,2,34,32
1,0,6,2,3,38,4,-34
1,0,3,0,3,81,58,-23
3,0,6,2,3,29,4,-25
3,0,2,0,5,126,5,-121
3,0,4,0,3,122,96,-26
1,0,0,0,3,149,43,-106
3,0,2,2,5,23,122,99
3,0,3,0,3,105,58,-47
3,0,1,0,3,9,464,455
1,0,0,0,3,303,92,-211
3,1,3,0,3,149,110,-39
2,0,0,0,3,98,65,-33
1,0,0,0,3,364,59,-305
3,0,1,0,3,70,99,29
3,0,0,4,3,119,16,-103
3,0,6,0,3,46,26,-20
3,0,0,0,3,86,131,45
3,1,0,4,3,23,75,52
2,0,2,1,5,141,16,-125
2,0,2,1,5,166,12,-154
1,0,0,1,3,44,29,-15
3,0,0,6,3,21,3,-18
3,1,6,2,3,10,58,48
3,0,2,0,5,120,20,-100
1,0,4,1,3,25,80,55
2,0,2,4,5,28,21,-7
3,1,0,6,3,87,13,-74
3,1,6,1,3,44,16,-28
3,0,1,6,3,9,37,28
3,0,3,0,3,33,37,4
1,0,3,0,3,82,66,-16
3,0,2,2,5,18,118,100
1,0,6,0,3,34,41,7
3,0,2,1,5,65,70,5
3,0,0,1,3,103,49,-54
3,0,1,1,3,22,42,20
3,1,1,4,3,33,9,-24
1,0,2,0,5,14,94,80
3,1,1,0,3,81,33,-48
3,0,3,1,3,60,12,-48
3,0,0,6,3,112,28,-84
3,1,0,4,3,6,65,59
3,0,1,1,3,21,820,799
1,0,3,0,3,19,90,71
1,0,2,3,5,41,80,39
3,1,1,0,3,58,27,-31
2,0,2,1,5,17,38,21
3,1,4,0,3,47,37,-10
1,0,0,6,3,70,62,-8
3,1,6,1,3,60,44,-16
3,0,5,0,3,81,54,-27
3,1,6,2,3,3,93,90
3,0,1,0,3,401,47,-354
2,0,2,1,5,54,28,-26
3,0,0,4,3,71,22,-49
1,0,3,0,3,87,31,-56
3,0,0,7,3,7,27,20
3,0,6,2,3,38,2,-36
3,0,0,6,3,53,45,-8
3,0,3,0,3,61,73,12
1,0,2,0,5,8,94,86
1,0,3,6,3,33,56,23
3,1,0,1,3,27,436,409
3,0,5,1,3,6,43,37
3,0,0,0,3,102,903,801
2,0,2,2,5,1,22,21
1,0,6,1,3,13,57,44
3,0,3,1,3,32,46,14
3,0,2,3,5,67,4,-63
3,0,1,2,3,19,30,11
3,0,0,1,3,82,152,70
3,0,6,2,3,22,16,-6
1,0,3,2,3,24,12,-12
3,1,3,7,3,57,44,-13
3,1,7,5,3,2,6,4
2,0,3,0,3,92,46,-46
1,0,0,1,3,90,22,-68
3,0,0,0,3,280,256,-24
3,0,3,0,3,109,128,19
3,0,5,3,3,3,16,13
3,0,4,0,3,199,49,-150
3,1,0,0,3,86,95,9
3,0,6,0,3,78,81,3
3,1,6,1,3,54,15,-39
2,0,1,0,3,79,10,-69
3,1,0,1,3,16,99,83
1,0,1,1,3,55,57,2
3,0,0,4,3,3,9,6
3,0,2,0,5,23,115,92
1,0,0,6,3,183,90,-93
3,0,5,0,3,39,34,-5
3,0,4,0,3,480,254,-226
1,0,4,0,3,295,73,-222
3,0,5,0,3,1,55,54
3,0,5,0,3,48,3,-45
3,1,3,0,3,53,101,48
3,0,0,0,3,23,71,48
3,1,0,1,3,103,15,-88
1,0,0,1,3,369,483,114
3,0,0,1,3,63,37,-26
2,0,2,2,5,6,31,25
3,0,3,0,3,52,74,22
3,0,2,1,5,24,69,45
3,1,0,6,3,484,9,-475
3,0,3,1,3,65,32,-33
3,0,5,1,3,25,15,-10
1,0,3,0,3,294,125,-169
3,0,3,1,3,48,12,-36
3,0,2,0,5,15,71,56
3,0,3,1,3,11,101,90
1,0,1,6,3,5,19,14
2,0,2,0,5,35,96,61
3,0,2,0,5,26,57,31
1,0,3,4,3,316,79,-237
3,0,2,1,5,35,16,-19
3,1,0,0,3,52,19,-33
3,0,2,1,5,39,29,-10
1,0,1,1,3,86,44,-42
3,0,3,1,3,98,119,21
3,0,2,0,5,56,8,-48
1,0,3,0,3,76,32,-44
1,0,2,0,5,148,70,-78
3,1,0,0,3,39,66,27
3,0,2,2,5,81,48,-33
1,0,6,3,3,35,6,-29
3,0,4,2,3,11,65,54
3,0,1,0,3,40,229,189
3,0,1,1,3,125,4,-121
1,0,5,2,3,48,37,-11
2,0,0,0,3,2159,69,-2090
1,0,5,0,3,42,69,27
1,0,2,0,5,78,26,-52
1,0,5,1,3,70,16,-54
3,1,0,4,3,63,53,-10
3,1,4,0,3,1086,88,-998
3,1,0,1,3,64,40,-24
3,0,6,0,3,13,41,28
1,0,5,0,3,17,53,36
1,0,3,1,3,2,82,80
3,0,3,0,3,70,51,-19
3,0,3,0,3,84,38,-46
1,0,6,0,3,51,53,2
3,0,0,0,3,97,115,18
1,0,5,0,3,39,51,12
3,1,0,0,3,22,180,158
3,0,3,0,3,205,102,-103
3,0,3,4,3,9,112,103
3,1,1,0,3,48,14,-34
3,0,6,1,3,6,73,67
3,0,5,3,3,20,6,-14
2,0,2,4,5,29,14,-15
1,0,3,0,3,253,430,177
3,0,5,1,3,423,22,-401
3,0,0,0,3,121,65,-56
3,0,6,2,3,13,62,49
1,0,2,0,5,47,118,71
3,0,5,2,3,29,8,-21
1,0,5,2,3,63,65,2
3,0,3,7,3,11,41,30
3,0,0,0,3,27,30,3
3,0,0,1,3,59,82,23
1,0,0,1,3,90,115,25
1,0,0,0,3,142,110,-32
3,1,6,0,3,106,69,-37
1,0,5,1,3,37,17,-20
1,0,6,0,3,30,11,-19
1,0,3,1,3,51,141,90
1,0,5,0,3,46,27,-19
1,0,6,0,3,37,17,-20
2,0,2,0,5,72,55,-17
3,0,6,1,3,112,24,-88
1,0,5,1,3,50,41,-9
3,0,5,2,3,22,9,-13
2,0,2,3,5,35,25,-10
1,0,6,1,3,4,24,20
3,0,6,2,3,44,23,-21
3,0,0,0,3,173,69,-104
1,0,3,5,3,133,1082,949
3,0,2,0,5,68,101,33
1,0,1,0,3,45,92,47
0,1,5,2,3,14,18,4
3,0,6,1,3,76,7,-69
3,1,0,0,3,173,43,-130
1,1,0,1,3,121,64,-57
3,0,6,2,3,63,57,-6
1,0,0,0,3,247,125,-122
3,0,5,2,3,19,9,-10
1,0,6,0,3,45,113,68
1,0,0,0,3,96,1512,1416
0,1,3,1,3,46,26,-20
3,0,6,0,3,68,64,-4
2,0,2,0,5,75,16,-59
1,0,0,0,3,66,90,24
3,0,4,0,3,40,191,151
1,0,2,0,5,13,100,87
3,1,0,1,3,124,23,-101
3,0,2,0,5,25,67,42
3,0,2,3,5,1,13,12
3,1,6,0,3,50,53,3
3,0,6,1,3,160,18,-142
2,0,0,1,3,99,116,17
3,0,3,0,3,394,110,-284
3,0,2,0,5,92,26,-66
3,0,0,2,3,47,21,-26
1,0,0,0,3,71,74,3
3,1,0,1,3,59,32,-27
2,0,2,1,5,30,49,19
3,0,0,4,3,12,118,106
2,0,0,4,3,60,63,3
3,0,5,2,3,67,8,-59
1,0,0,4,3,20,40,20
3,0,6,2,3,14,29,15
1,0,0,1,3,22,74,52
3,0,6,0,3,122,47,-75
3,0,0,0,3,10,193,183
3,0,2,0,5,243,37,-206
3,1,6,1,3,22,18,-4
2,0,2,0,5,90,50,-40
3,0,0,1,3,92,75,-17
3,1,0,4,3,51,190,139
3,0,6,0,3,47,28,-19
1,0,2,0,5,5,60,55
0,1,3,0,3,33,128,95
1,0,3,1,3,4,65,61
2,0,1,0,3,121,61,-60
1,0,2,2,5,18,11,-7
1,0,5,2,3,7,11,4
1,0,3,0,3,553,56,-497
3,0,2,0,5,53,40,-13
1,0,4,1,3,37,156,119
3,0,0,2,3,43,22,-21
0,1,5,2,3,85,21,-64
2,0,2,4,5,2,36,34
1,0,0,0,3,18,101,83
1,0,1,1,3,5,56,51
1,0,1,6,3,114,5,-109
1,0,2,1,5,72,29,-43
1,0,0,0,3,66,177,111
3,0,0,0,3,67,62,-5
3,1,0,0,3,39,75,36
3,0,0,4,3,4,84,80
3,1,4,0,3,76,71,-5
3,0,3,4,3,24,10,-14
3,0,6,0,3,54,56,2
1,0,3,1,3,79,120,41
3,0,6,4,3,25,6,-19
0,1,4,6,3,7,48,41
2,0,2,2,5,1093,67,-1026
3,0,3,6,3,11,66,55
3,0,6,0,3,16,55,39
0,1,5,4,3,11,5,-6
3,0,0,0,3,67,66,-1
3,0,6,6,3,2,3,1
3,0,3,1,3,40,107,67
1,0,6,1,3,34,22,-12
0,1,3,6,3,37,26,-11
3,1,0,6,3,21,8,-13
3,0,3,0,3,39,70,31
3,1,4,4,3,3,44,41
2,0,2,0,5,147,121,-26
3,1,0,0,3,56,60,4
3,0,2,0,5,107,68,-39
1,0,0,0,3,33,530,497
3,0,5,2,3,39,5,-34
1,0,3,4,3,151,31,-120
1,0,0,0,3,115,304,189
1,1,0,1,3,166,38,-128
1,0,2,0,5,178,102,-76
1,0,6,0,3,31,35,4
1,0,6,4,3,9,4,-5
3,0,2,2,5,19,44,25
1,0,0,1,3,292,143,-149
3,0,6,1,3,76,7,-69
3,0,2,0,5,35,312,277
3,0,6,0,3,79,156,77
3,0,2,1,5,63,30,-33
1,0,1,1,3,76,85,9
3,0,3,0,3,31,70,39
3,0,2,2,5,100,14,-86
3,1,1,0,3,140,16,-124
1,0,0,0,3,46,20,-26
0,1,3,0,3,102,93,-9
1,0,3,0,3,496,170,-326
1,0,2,0,5,25,44,19
3,0,3,1,3,24,208,184
1,0,6,1,3,7,93,86
3,0,6,1,3,6,49,43
3,1,6,0,3,76,50,-26
3,0,0,7,3,44,23,-21
3,1,0,1,3,96,20,-76
3,0,5,4,3,3,7,4
3,0,3,0,3,43,141,98
1,0,3,0,3,103,113,10
3,0,6,3,3,6,18,12
3,0,5,1,3,52,24,-28
3,1,1,1,3,62,38,-24
1,0,3,4,3,34,140,106
3,0,2,0,5,85,101,16
1,0,6,2,3,41,18,-23
3,0,0,0,3,105,70,-35
1,0,1,0,3,76,140,64
2,0,2,0,5,152,99,-53
1,0,0,6,3,22,319,297
3,0,6,2,3,14,19,5
1,0,1,1,3,12,99,87
3,1,0,0,3,39,217,178
3,0,2,2,5,2,38,36
3,0,6,1,3,94,6,-88
3,1,3,7,3,48,80,32
3,0,0,0,3,194,56,-138
3,1,0,0,3,73,55,-18
3,0,4,7,3,55,1,-54
1,0,0,0,3,70,75,5
3,1,0,7,3,18,243,225
3,0,5,4,3,1,7,6
1,0,2,0,5,80,100,20
2,0,2,3,5,12,6,-6
1,0,0,0,3,34,72,38
0,1,3,1,3,27,68,41
3,1,7,5,3,1,6,5
3,0,0,1,3,227,46,-181
3,0,1,4,3,32,34,2
3,1,6,1,3,15,75,60
2,0,2,1,5,119,37,-82
3,0,2,3,5,4,17,13
3,0,6,0,3,42,70,28
2,0,0,4,3,91,61,-30
1,0,0,0,3,118,65,-53
1,0,4,1,3,68,240,172
3,0,6,1,3,109,13,-96
0,1,3,1,3,14,43,29
3,0,4,1,3,46,112,66
2,0,2,0,5,103,96,-7
3,1,0,0,3,140,549,409
3,0,3,7,3,38,45,7
1,0,0,1,3,93,18,-75
3,1,4,1,3,52,1,-51
3,1,0,0,3,30,50,20
3,1,6,0,3,56,27,-29
3,1,0,1,3,48,98,50
0,1,5,1,3,65,10,-55
3,0,3,0,3,123,22,-101
3,1,3,1,3,94,50,-44
3,0,1,0,3,422,61,-361
3,0,5,1,3,13,35,22
1,0,5,1,3,26,30,4
1,0,1,1,3,140,36,-104
3,1,4,1,3,48,54,6
3,0,1,0,3,116,83,-33
3,1,4,0,3,89,124,35
3,1,0,4,3,10,92,82
3,1,0,1,3,83,36,-47
1,0,5,0,3,56,72,16
1,0,4,1,3,16,242,226
3,1,3,0,3,117,111,-6
2,0,0,0,3,21,73,52
2,0,3,0,3,54,35,-19
2,0,0,4,3,552,262,-290
1,0,3,4,3,47,68,21
1,0,2,0,5,13,74,61
3,1,5,0,3,41,33,-8
3,0,0,0,3,663,106,-557
2,0,3,0,3,755,140,-615
3,0,2,1,5,143,42,-101
1,0,6,0,3,24,93,69
3,0,2,0,5,168,123,-45
3,0,3,1,3,66,70,4
1,0,6,2,3,28,15,-13
1,0,1,4,3,10,30,20
3,0,6,0,3,73,317,244
3,1,6,0,3,57,42,-15
2,0,3,1,3,123,171,48
3,0,0,0,3,562,83,-479
3,0,0,0,3,75,87,12
3,1,0,0,3,17,47,30
2,0,0,1,3,62,72,10
3,0,6,3,3,65,37,-28
3,0,3,0,3,12,96,84
3,0,6,0,3,112,127,15
3,0,0,1,3,29,72,43
3,1,0,6,3,11,127,116
1,0,3,0,3,166,90,-76
3,1,4,0,3,44,188,144
3,1,6,2,3,20,4,-16
3,0,0,0,3,31,52,21
3,0,5,0,3,26,13,-13
3,0,2,1,5,76,11,-65
3,0,5,4,3,14,86,72
1,0,1,0,3,83,105,22
1,0,3,1,3,113,352,239
1,0,1,1,3,64,6,-58
3,1,0,7,3,60,11,-49
3,0,6,1,3,1,128,127
3,0,5,2,3,15,3,-12
2,0,2,0,5,2,93,91
3,0,1,0,3,5,31,26
3,0,0,0,3,58,76,18
3,0,3,0,3,79,122,43
3,1,1,1,3,30,13,-17
3,0,5,1,3,71,27,-44
3,0,0,0,3,57,27,-30
3,0,2,1,5,114,10,-104
3,0,0,0,3,84,69,-15
1,0,0,0,3,52,102,50
3,0,1,1,3,26,102,76
1,0,0,0,3,57,188,131
3,0,5,2,3,30,8,-22
1,0,3,4,3,71,154,83
2,0,2,2,5,35,102,67
3,0,3,0,3,246,58,-188
1,0,0,1,3,61,60,-1
1,0,1,1,3,11,135,124
3,1,6,1,3,6,15,9
3,0,6,2,3,32,56,24
3,0,3,0,3,204,167,-37
3,0,3,1,3,72,176,104
1,0,5,0,3,112,21,-91
1,0,3,4,3,51,61,10
3,0,1,4,3,20,44,24
1,0,3,0,3,104,102,-2
3,1,6,0,3,54,43,-11
3,0,1,0,3,158,90,-68
1,0,1,1,3,113,15,-98
1,0,0,4,3,43,118,75
1,0,3,1,3,294,63,-231
3,0,6,1,3,38,25,-13
1,0,2,4,5,3,14,11
3,1,6,0,3,11,66,55
3,0,6,0,3,48,71,23
3,0,1,1,3,24,145,121
3,0,2,0,5,37,12,-25
0,1,4,1,3,38,5,-33
0,1,3,0,3,30,48,18
2,0,0,0,3,92,132,40
3,0,1,0,3,16,64,48
3,1,0,1,3,60,36,-24
1,0,0,6,3,30,46,16
1,0,5,1,3,62,61,-1
1,1,0,4,3,30,110,80
2,0,2,0,5,205,119,-86
3,1,0,6,3,9,182,173
1,0,0,0,3,661,68,-593
3,0,2,0,5,802,93,-709
3,0,1,0,3,57,227,170
3,0,0,0,3,67,97,30
1,0,0,0,3,30,78,48
1,0,6,1,3,74,10,-64
3,0,5,0,3,124,42,-82
3,0,2,0,5,28,223,195
1,1,0,1,3,22,88,66
3,1,5,6,3,9,12,3
1,0,4,0,3,124,137,13
3,0,1,0,3,176,21,-155
3,0,3,0,3,59,12,-47
3,0,1,0,3,53,107,54
3,0,5,1,3,123,2,-121
1,0,3,6,3,29,24,-5
3,0,4,2,3,1,53,52
3,1,3,6,3,14,43,29
3,0,5,0,3,115,117,2
3,0,4,4,3,107,41,-66
1,0,6,2,3,51,3,-48
3,0,4,1,3,145,13,-132
1,0,0,1,3,16,91,75
1,0,0,1,3,86,60,-26
1,0,4,0,3,117,85,-32
2,0,2,2,5,10,126,116
3,1,3,0,3,739,77,-662
3,0,0,1,3,316,18,-298
1,0,3,0,3,110,243,133
1,0,0,4,3,63,158,95
1,0,6,2,3,38,13,-25
2,0,3,1,3,95,33,-62
3,0,2,0,5,177,40,-137
3,1,0,1,3,79,20,-59
3,1,3,7,3,42,7,-35
1,0,0,0,3,61,738,677
3,1,0,1,3,48,17,-31
3,0,6,0,3,113,43,-70
3,1,0,1,3,82,81,-1
3,0,3,0,3,115,164,49
3,0,0,2,3,29,38,9
3,1,1,0,3,11,247,236
3,0,3,0,3,165,26,-139
1,0,3,4,3,9,70,61
2,0,2,0,5,94,27,-67
1,0,0,0,3,166,920,754
3,0,4,0,3,103,193,90
1,0,2,0,5,100,36,-64
1,0,5,0,3,29,93,64
3,0,2,0,5,121,18,-103
1,0,6,2,3,29,7,-22
3,0,3,0,3,143,232,89
3,1,6,0,3,27,53,26
2,0,0,6,3,26,23,-3
1,0,3,1,3,112,85,-27
3,0,3,0,3,91,94,3
3,1,0,0,3,140,52,-88
0,1,3,1,3,37,64,27
2,0,2,4,5,130,22,-108
1,0,1,0,3,53,141,88
3,0,0,0,3,47,346,299
3,0,0,1,3,49,1,-48
3,1,0,1,3,59,66,7
3,0,6,1,3,47,25,-22
3,0,2,1,5,21,53,32
3,0,5,0,3,50,20,-30
3,0,2,2,5,19,15,-4
1,0,3,6,3,20,111,91
3,0,1,0,3,11,44,33
1,0,4,0,3,430,83,-347
1,0,3,1,3,77,122,45
1,0,0,4,3,45,16,-29
0,1,5,2,3,4,10,6
3,1,0,0,3,100,47,-53
3,0,2,0,5,90,71,-19
2,0,2,0,5,125,25,-100
1,0,0,1,3,18,59,41
1,0,0,4,3,263,5,-258
3,0,4,0,3,238,68,-170
1,0,5,1,3,19,61,42
1,0,0,4,3,77,45,-32
2,0,0,6,3,41,22,-19
3,0,6,0,3,69,129,60
3,0,2,1,5,77,31,-46
3,1,0,7,3,11,34,23
1,0,3,6,3,58,91,33
1,0,0,4,3,14,18,4
3,1,3,4,3,86,14,-72
1,0,6,2,3,9,12,3
3,1,0,0,3,129,108,-21
1,0,2,1,5,25,116,91
3,0,3,1,3,186,105,-81
3,0,5,1,3,8,222,214
3,0,6,2,3,42,12,-30
3,0,5,0,3,116,85,-31
2,0,0,1,3,44,53,9
3,0,3,0,3,72,89,17
1,0,1,1,3,46,31,-15
1,0,0,4,3,104,70,-34
1,0,0,0,3,76,129,53
1,0,5,1,3,53,13,-40
1,0,3,1,3,49,101,52
3,0,4,1,3,27,100,73
1,0,3,0,3,69,65,-4
3,1,3,0,3,108,54,-54
3,0,6,0,3,74,15,-59
3,0,0,0,3,84,106,22
3,0,6,1,3,55,109,54
1,0,3,0,3,58,148,90
1,0,0,7,3,207,136,-71
1,0,3,1,3,132,81,-51
3,0,2,1,5,186,29,-157
1,1,0,4,3,149,77,-72
3,0,0,4,3,195,32,-163
3,0,6,0,3,116,94,-22
1,0,2,1,5,153,74,-79
2,0,2,0,5,66,83,17
1,0,1,0,3,74,70,-4
3,1,0,0,3,33,198,165
3,0,5,1,3,31,4,-27
3,1,3,1,3,175,43,-132
1,0,6,0,3,84,29,-55
3,1,1,4,3,101,5,-96
3,0,5,1,3,53,25,-28
1,0,5,0,3,67,30,-37
3,0,2,0,5,100,4,-96
3,0,6,1,3,32,42,10
3,0,2,0,5,17,98,81
3,0,2,0,5,233,37,-196
2,0,0,7,3,70,42,-28
3,0,0,4,3,30,88,58
3,0,1,0,3,16,55,39
3,0,6,2,3,39,31,-8
3,0,6,0,3,55,25,-30
3,0,6,0,3,20,27,7
3,1,0,0,3,57,67,10
3,0,0,1,3,56,6,-50
1,0,0,7,3,28,15,-13
1,0,2,0,5,78,29,-49
1,0,6,1,3,174,1,-173
2,0,0,6,3,47,46,-1
3,0,0,1,3,90,252,162
2,0,2,0,5,38,44,6
3,0,6,0,3,14,28,14
3,0,1,0,3,55,36,-19
1,0,3,4,3,74,78,4
3,0,6,0,3,48,50,2
3,0,6,3,3,39,8,-31
3,1,0,1,3,7,124,117
3,0,5,1,3,96,9,-87
3,0,0,0,3,93,69,-24
3,0,6,1,3,51,16,-35
3,0,6,2,3,29,6,-23
3,1,7,5,3,7,9,2
2,0,2,1,5,5,70,65
3,0,2,1,5,4,234,230
1,0,0,7,3,50,53,3
3,0,6,0,3,53,33,-20
3,0,6,0,3,54,105,51
1,0,0,0,3,102,108,6
3,0,4,0,3,47,15,-32
3,0,6,0,3,29,51,22
3,0,2,1,5,126,5,-121
2,0,3,1,3,22,42,20
3,0,6,0,3,87,82,-5
1,0,4,6,3,47,11,-36
3,0,6,3,3,4,13,9
1,0,6,3,3,16,135,119
1,0,6,0,3,65,22,-43
1,0,0,1,3,71,43,-28
3,0,3,0,3,115,222,107
3,0,6,3,3,1,16,15
3,1,0,0,3,97,89,-8
1,0,0,4,3,107,75,-32
2,0,1,1,3,46,72,26
2,0,2,1,5,1,55,54
3,0,1,0,3,81,43,-38
1,0,0,1,3,10,3065,3055
1,0,3,1,3,44,78,34
3,0,6,0,3,25,16,-9
3,1,0,1,3,112,14,-98
3,1,7,5,3,8,2,-6
1,0,0,0,3,88,78,-10
3,0,6,2,3,26,24,-2
1,0,0,0,3,87,75,-12
1,0,3,6,3,84,108,24
3,1,0,0,3,62,319,257
2,0,0,1,3,87,52,-35
3,0,2,1,5,129,25,-104
3,0,2,0,5,272,93,-179
3,0,2,0,5,47,71,24
3,1,1,0,3,37,70,33
2,0,0,1,3,43,29,-14
1,0,2,0,5,31,58,27
1,0,3,4,3,308,164,-144
1,0,2,1,5,4,35,31
3,0,6,1,3,33,75,42
1,0,3,0,3,91,80,-11
1,0,4,1,3,83,131,48
3,1,0,0,3,37,47,10
1,0,1,0,3,57,113,56
1,0,5,0,3,72,59,-13
3,1,3,0,3,300,75,-225
3,1,1,0,3,23,13,-10
3,0,6,1,3,44,12,-32
3,0,4,6,3,34,1,-33
3,0,0,0,3,79,54,-25
2,0,2,0,5,79,253,174
3,0,2,0,5,152,59,-93
1,0,6,0,3,34,159,125
3,0,2,0,5,95,116,21
1,0,6,1,3,29,5,-24
3,1,0,1,3,60,135,75
1,0,5,2,3,26,1,-25
1,0,0,4,3,114,121,7
1,0,1,4,3,56,83,27
3,0,0,0,3,52,529,477
3,1,5,2,3,30,9,-21
2,0,0,4,3,73,240,167
3,0,6,1,3,24,1,-23
3,0,2,1,5,56,34,-22
2,0,0,4,3,9,33,24
3,0,1,6,3,21,32,11
1,0,2,0,5,77,78,1
3,0,1,1,3,30,2,-28
1,0,3,0,3,101,78,-23
3,1,1,0,3,46,43,-3
3,1,6,1,3,9,36,27
1,0,3,0,3,159,117,-42
2,0,2,1,5,100,79,-21
3,0,6,4,3,13,11,-2
2,0,3,6,3,130,149,19
3,1,0,0,3,89,38,-51
1,0,0,4,3,61,77,16
1,0,3,7,3,63,56,-7
1,0,3,4,3,72,5,-67
3,0,2,0,5,3,78,75
3,1,3,0,3,14,283,269
2,0,0,6,3,34,39,5
3,0,6,1,3,71,27,-44
3,1,1,0,3,40,46,6
1,0,0,4,3,56,57,1
1,0,3,1,3,27,62,35
2,0,2,1,5,63,52,-11
3,0,0,0,3,454,67,-387
3,0,2,0,5,61,102,41
3,0,6,4,3,2,5,3
1,0,5,2,3,68,6,-62
3,0,1,1,3,82,17,-65
1,0,3,4,3,10,52,42
3,0,1,0,3,9,77,68
2,0,3,0,3,46,82,36
3,0,2,3,5,23,36,13
1,0,0,0,3,103,80,-23
1,0,1,1,3,73,21,-52
3,0,0,1,3,55,230,175
1,0,0,1,3,90,52,-38
3,0,6,0,3,76,53,-23
3,0,3,1,3,133,222,89
3,0,5,2,3,122,32,-90
3,1,0,0,3,67,49,-18
3,1,0,0,3,22,62,40
3,0,1,0,3,152,102,-50
1,0,0,0,3,93,51,-42
2,0,2,3,5,27,152,125
1,0,0,0,3,108,241,133
1,0,3,4,3,73,152,79
3,0,6,2,3,545,59,-486
1,0,0,0,3,116,88,-28
0,1,3,1,3,25,61,36
1,0,0,0,3,88,65,-23
2,0,2,1,5,123,133,10
0,1,3,0,3,34,35,1
3,0,2,0,5,65,29,-36
3,0,3,0,3,5,146,141
3,0,2,0,5,59,207,148
3,0,6,1,3,24,83,59
1,0,0,0,3,107,90,-17
3,0,0,4,3,30,78,48
3,0,2,3,5,8,42,34
2,0,1,0,3,49,6,-43
3,1,4,0,3,107,28,-79
3,0,2,0,5,69,142,73
3,1,3,4,3,63,36,-27
0,1,5,1,3,5,30,25
1,0,0,0,3,52,94,42
3,0,2,0,5,173,9,-164
1,0,3,0,3,71,88,17
3,1,0,4,3,105,67,-38
3,0,5,7,5,1,14,13
3,1,5,1,3,96,24,-72
3,0,3,2,3,76,24,-52
1,0,0,1,3,96,75,-21
3,1,0,1,3,62,164,102
1,0,0,0,3,195,30,-165
3,1,1,1,3,57,8,-49
3,0,2,0,5,179,151,-28
2,0,0,0,3,235,101,-134
3,1,1,4,3,13,14,1
3,0,3,0,3,55,32,-23
3,0,2,0,5,19,56,37
3,0,0,1,3,46,53,7
3,0,3,1,3,106,12,-94
1,0,3,0,3,126,4,-122
3,0,2,3,5,141,55,-86
3,0,3,4,3,36,3,-33
1,0,6,4,3,6,3,-3
1,0,3,1,3,80,34,-46
3,1,0,0,3,86,115,29
2,0,2,2,5,80,63,-17
3,0,3,0,3,107,197,90
3,0,2,2,5,8,56,48
3,0,1,4,3,46,37,-9
1,0,4,1,3,95,80,-15
3,1,0,0,3,75,110,35
1,0,3,1,3,25,75,50
3,0,6,0,3,113,103,-10
3,1,3,0,3,26,52,26
3,1,3,0,3,107,7,-100
3,1,3,4,3,368,151,-217
3,0,1,0,3,142,12,-130
2,0,3,1,3,108,36,-72
1,0,3,0,3,266,59,-207
1,0,5,2,3,21,63,42
2,0,0,0,3,444,51,-393
3,0,5,1,3,29,86,57
2,0,0,0,3,108,99,-9
3,1,1,0,3,85,7,-78
3,1,0,0,3,103,126,23
1,0,3,0,3,133,29,-104
2,0,2,1,5,121,80,-41
1,0,0,1,3,348,33,-315
1,0,0,1,3,126,115,-11
1,0,3,4,3,39,45,6
1,0,2,0,5,30,115,85
2,0,2,2,5,56,76,20
3,1,1,1,3,25,4,-21
1,0,2,7,5,4,3,-1
1,0,0,1,3,35,157,122
1,0,0,0,3,54,72,18
2,0,1,1,3,63,30,-33
3,1,3,4,3,37,122,85
3,0,6,2,3,1,49,48
1,0,4,1,3,47,48,1
3,0,2,1,5,43,72,29
1,0,0,4,3,8,81,73
1,0,0,1,3,82,33,-49
3,0,3,0,3,101,182,81
1,0,0,1,3,31,100,69
1,0,0,1,3,129,29,-100
3,0,3,1,3,281,36,-245
1,0,0,0,3,113,243,130
3,0,5,1,3,10,55,45
1,0,2,0,5,79,75,-4
1,0,3,0,3,67,61,-6
3,1,1,0,3,63,75,12
3,0,6,1,3,54,19,-35
3,0,1,0,3,79,65,-14
1,0,2,1,5,3,144,141
3,0,5,2,3,17,19,2
3,0,3,0,3,61,90,29
3,0,2,1,5,21,67,46
1,0,4,0,3,105,128,23
1,0,2,3,5,9,35,26
3,0,1,4,3,215,41,-174
3,0,0,0,3,65,38,-27
3,1,6,1,3,32,25,-7
1,0,5,1,3,55,96,41
1,0,3,0,3,65,563,498
3,0,1,0,3,85,141,56
3,0,0,0,3,39,77,38
1,1,0,1,3,36,103,67
1,0,0,0,3,53,39,-14
3,0,3,1,3,46,153,107
1,0,0,0,3,51,65,14
1,0,0,0,3,122,95,-27
1,1,0,0,3,101,85,-16
3,0,5,1,3,106,8,-98
1,0,5,2,3,83,55,-28
1,0,4,0,3,193,124,-69
3,0,0,0,3,78,19,-59
3,0,0,0,3,234,39,-195
1,0,0,4,3,23,33,10
3,0,3,0,3,10,239,229
3,1,0,0,3,80,148,68
3,1,1,1,3,13,28,15
1,0,2,2,5,9,58,49
3,1,3,0,3,47,158,111
2,0,2,1,5,49,8,-41
3,0,5,0,3,77,7,-70
3,0,0,6,3,20,10,-10
2,0,2,0,5,30,109,79
3,0,3,0,3,119,112,-7
1,0,3,0,3,93,214,121
3,1,0,4,3,95,86,-9
3,0,5,0,3,57,45,-12
1,0,5,0,3,44,87,43
0,1,3,0,3,88,85,-3
2,0,0,0,3,79,56,-23
1,0,4,0,3,69,49,-20
1,0,0,6,3,5,12,7
3,0,1,2,3,65,107,42
3,0,1,0,3,32,26,-6
3,0,1,0,3,82,166,84
2,0,0,1,3,76,157,81
3,0,1,1,3,214,5,-209
1,0,5,0,3,1,48,47
1,0,5,0,3,146,13,-133
1,0,0,1,3,21,89,68
1,0,0,4,3,37,39,2
3,0,3,0,3,64,36,-28
1,0,3,0,3,78,46,-32
3,0,2,2,5,4,32,28
1,0,5,1,3,69,17,-52
3,0,0,0,3,101,95,-6
2,0,0,1,3,263,43,-220
3,0,0,1,3,115,112,-3
2,0,0,4,3,90,47,-43
1,0,6,1,3,65,13,-52
3,1,5,0,3,62,51,-11
1,1,0,1,3,86,104,18
2,0,2,0,5,19,171,152
3,0,6,1,3,273,11,-262
1,0,0,0,3,109,111,2
3,0,5,0,3,128,50,-78
1,0,3,0,3,101,86,-15
3,1,0,1,3,34,87,53
2,0,2,1,5,23,81,58
3,0,2,2,5,2,34,32
1,0,0,4,3,76,110,34
2,0,2,1,5,32,123,91
2,0,0,0,3,59,74,15
3,0,6,0,3,95,78,-17
3,0,6,2,3,84,3,-81
3,0,2,0,5,108,35,-73
3,0,2,3,5,11,6,-5
3,0,2,1,5,79,28,-51
3,1,0,1,3,87,35,-52
1,0,0,0,3,4,64,60
0,1,5,1,3,12,17,5
3,0,0,1,3,797,58,-739
3,1,0,0,3,88,66,-22
1,0,0,1,3,67,21,-46
1,0,4,1,3,6,74,68
1,0,2,0,5,31,548,517
2,0,3,1,3,359,73,-286
3,1,3,0,3,120,16,-104
1,0,4,2,3,88,83,-5
3,0,4,0,3,97,720,623
2,0,2,3,5,2,26,24
1,0,0,0,3,160,5,-155
1,0,3,1,3,94,89,-5
3,0,2,0,5,129,32,-97
3,0,5,4,3,67,5,-62
3,1,1,1,3,30,6,-24
3,0,6,2,3,9,36,27
1,0,0,1,3,78,46,-32
1,0,2,0,5,87,32,-55
1,0,3,4,3,84,46,-38
3,1,0,1,3,160,87,-73
1,0,3,0,3,116,128,12
2,0,2,0,5,49,65,16
0,1,3,0,3,74,104,30
1,0,3,4,3,96,93,-3
1,0,0,0,3,76,78,2
1,0,0,7,3,86,72,-14
3,1,0,0,3,62,61,-1
3,1,3,1,3,91,38,-53
3,0,3,0,3,532,17,-515
3,1,7,5,3,3,7,4
2,0,3,0,3,124,42,-82
1,0,6,0,3,212,20,-192
2,0,2,0,5,106,13,-93
3,0,1,1,3,25,154,129
3,1,0,6,3,93,31,-62
1,0,0,1,3,65,8,-57
3,0,4,0,3,168,141,-27
3,1,3,1,3,161,97,-64
1,0,0,1,3,39,184,145
1,1,0,0,3,91,73,-18
3,0,4,0,3,478,143,-335
3,1,0,0,3,82,36,-46
3,0,1,1,3,79,86,7
2,0,0,0,3,86,91,5
3,0,6,4,3,3,60,57
3,0,2,3,5,46,4,-42
3,0,7,5,3,7,6,-1
1,0,3,0,3,72,53,-19
1,0,4,2,3,36,60,24
3,0,0,1,3,58,360,302
1,0,4,0,3,86,89,3
3,0,5,0,3,17,197,180
1,0,3,1,3,65,223,158
3,0,6,0,3,51,519,468
1,0,0,1,3,124,14,-110
3,0,6,1,3,16,73,57
3,0,0,1,3,323,15,-308
3,0,0,0,3,74,63,-11
3,0,2,0,5,253,117,-136
3,0,2,2,5,5,61,56
3,0,5,6,3,16,1,-15
1,0,3,0,3,146,162,16
3,0,1,1,3,118,48,-70
3,0,6,1,3,7,102,95
3,0,2,0,5,90,108,18
3,0,2,1,5,228,69,-159
2,0,2,1,5,3,68,65
2,0,2,0,5,119,12,-107
2,0,0,4,3,26,67,41
3,0,5,2,3,13,106,93
3,0,1,4,3,17,10,-7
3,1,1,1,3,99,36,-63
1,0,3,1,3,63,12,-51
3,0,4,1,3,66,247,181
3,1,0,1,3,35,72,37
3,0,6,1,3,62,23,-39
3,0,5,1,3,2,73,71
3,1,4,6,3,24,58,34
3,0,2,1,5,74,8,-66
3,0,2,1,5,15,89,74
1,0,6,2,3,5,48,43
3,0,1,0,3,73,43,-30
3,0,5,2,3,2,51,49
1,0,4,6,3,32,41,9
3,0,2,1,5,64,65,1
3,0,4,0,3,119,204,85
3,1,0,4,3,81,65,-16
3,0,5,3,3,59,61,2
3,0,0,4,3,46,98,52
3,0,3,1,3,21,38,17
3,0,0,1,3,79,8,-71
3,0,3,0,3,76,65,-11
1,0,3,5,3,87,66,-21
3,1,0,1,3,20,98,78
1,0,6,2,3,1,29,28
2,0,2,6,5,3,7,4
2,0,0,0,3,109,108,-1
1,0,1,0,3,56,27,-29
1,0,0,0,3,79,52,-27
1,0,3,0,3,81,118,37
1,0,2,0,5,177,81,-96
2,0,0,0,3,40,82,42
3,1,3,4,3,83,58,-25
1,0,3,4,3,100,119,19
2,0,2,0,5,81,19,-62
3,0,2,0,5,16,581,565
3,0,2,1,5,185,134,-51
3,0,6,0,3,66,18,-48
3,0,5,2,3,87,12,-75
3,1,6,2,3,60,5,-55
1,0,6,1,3,1,32,31
3,0,3,4,3,20,41,21
0,1,3,0,3,68,46,-22
3,1,0,0,3,42,56,14
2,0,0,4,3,51,89,38
2,0,0,6,3,289,54,-235
3,0,2,1,5,77,41,-36
3,0,0,1,3,46,69,23
3,1,1,0,3,25,18,-7
2,0,2,0,5,91,106,15
2,0,0,0,3,33,34,1
3,1,4,1,3,75,18,-57
3,1,0,0,3,148,303,155
1,0,6,0,3,55,26,-29
3,0,0,4,3,18,120,102
1,0,5,4,3,62,29,-33
1,0,0,1,3,76,69,-7
1,0,0,1,3,85,80,-5
1,0,2,0,5,168,75,-93
3,0,3,4,3,45,33,-12
1,0,0,7,3,255,1,-254
3,0,2,0,5,118,231,113
3,0,6,0,3,55,37,-18
3,0,2,1,5,1,50,49
1,0,2,1,5,13,41,28
1,0,0,0,3,76,131,55
3,1,0,4,3,45,511,466
3,0,5,2,3,60,36,-24
1,0,3,0,3,63,316,253
3,0,2,0,5,58,85,27
1,0,2,0,5,21,36,15
3,1,3,0,3,55,79,24
1,0,3,6,3,48,47,-1
3,0,6,1,3,134,32,-102
3,0,3,0,3,60,174,114
1,0,6,0,3,13,53,40
2,0,3,1,3,45,380,335
3,0,0,4,3,5,79,74
3,1,1,0,3,70,37,-33
3,0,0,0,3,125,78,-47
3,0,2,1,5,79,8,-71
3,1,0,0,3,227,45,-182
1,0,5,0,3,41,3,-38
1,0,3,4,3,76,48,-28
3,0,1,1,3,24,25,1
2,0,2,0,5,257,129,-128
3,1,3,0,3,113,84,-29
3,1,3,1,3,25,73,48
3,0,2,0,5,120,145,25
1,0,2,0,5,102,93,-9
2,0,2,0,5,48,51,3
3,0,4,1,3,135,39,-96
1,0,3,0,3,114,128,14
3,0,5,1,3,265,19,-246
3,0,3,0,3,10,136,126
1,0,5,1,3,16,52,36
1,0,1,4,3,106,133,27
3,0,3,0,3,41,34,-7
3,0,0,0,3,20,251,231
1,0,0,0,3,68,50,-18
1,0,3,1,3,75,31,-44
3,0,4,0,3,22,1015,993
3,1,0,4,3,30,110,80
3,0,6,0,3,94,90,-4
1,0,1,0,3,46,23,-23
1,0,0,1,3,24,67,43
3,1,0,1,3,72,21,-51
0,1,3,4,3,65,37,-28
1,0,6,0,3,46,57,11
3,0,0,0,3,60,86,26
3,0,6,2,3,158,55,-103
1,0,6,0,3,47,18,-29
1,0,3,1,3,85,26,-59
3,0,3,4,3,42,16,-26
1,0,3,4,3,86,10,-76
3,0,3,1,3,31,24,-7
3,0,4,0,3,36,31,-5
1,0,1,0,3,18,54,36
2,0,2,3,5,9,5,-4
3,0,2,0,5,73,92,19
3,1,4,0,3,38,19,-19
1,0,2,1,5,10,87,77
1,0,6,2,3,3,18,15
3,1,0,6,3,44,28,-16
1,0,0,0,3,244,133,-111
1,0,5,1,3,68,13,-55
3,0,4,0,3,51,10,-41
3,0,5,0,3,39,36,-3
3,1,4,0,3,100,21,-79
1,0,3,0,3,381,115,-266
3,1,0,0,3,107,24,-83
2,0,1,6,3,38,5,-33
3,0,0,1,3,49,231,182
3,0,5,1,3,1,38,37
3,0,6,2,3,37,5,-32
1,0,3,0,3,42,655,613
3,0,4,2,3,35,57,22
2,0,2,0,5,38,225,187
1,0,2,0,5,67,85,18
2,0,2,0,5,1093,111,-982
3,0,2,2,5,3,24,21
3,0,6,0,3,80,40,-40
2,0,2,0,5,73,53,-20
3,0,5,0,3,7,53,46
3,1,0,6,3,18,39,21
2,0,0,1,3,61,7,-54
1,0,6,0,3,40,97,57
3,0,0,1,3,22,95,73
3,1,0,0,3,104,55,-49
3,0,6,1,3,53,32,-21
3,0,6,1,3,12,38,26
3,0,6,0,3,79,58,-21
1,0,4,1,3,86,4,-82
3,0,3,1,3,173,2,-171
0,1,3,0,3,13,114,101
3,0,6,1,3,26,3,-23
2,0,2,0,5,111,58,-53
1,0,0,0,3,108,77,-31
2,0,0,0,3,169,101,-68
1,0,2,1,5,27,78,51
3,0,2,0,5,85,11,-74
1,0,2,0,5,199,11,-188
3,0,1,7,3,80,1,-79
3,0,2,2,5,15,69,54
3,0,6,0,3,69,128,59
3,0,1,0,3,69,30,-39
1,0,6,1,3,8,104,96
1,0,2,0,5,284,107,-177
3,0,3,1,3,134,52,-82
3,0,5,2,3,99,41,-58
2,0,2,0,5,22,61,39
3,1,4,1,3,36,92,56
2,0,3,4,3,75,44,-31
3,1,0,1,3,68,105,37
3,1,0,0,3,207,150,-57
3,0,4,7,3,6,41,35
2,0,3,1,3,16,239,223
1,0,0,4,3,49,13,-36
3,0,2,1,5,40,215,175
3,0,2,0,5,65,25,-40
1,0,2,1,5,9,133,124
3,0,2,0,5,710,27,-683
3,1,0,4,3,95,119,24
1,0,3,6,3,19,101,82
3,0,3,1,3,43,44,1
3,0,2,0,5,88,77,-11
1,0,1,0,3,26,171,145
1,0,0,4,3,100,52,-48
1,0,0,1,3,99,115,16
1,0,0,4,3,91,62,-29
2,0,2,2,5,96,79,-17
1,0,6,0,3,24,10,-14
2,0,2,1,5,182,15,-167
1,0,3,1,3,219,73,-146
2,0,2,1,5,211,7,-204
3,0,5,0,3,60,56,-4
3,0,3,1,3,45,9,-36
3,1,1,6,3,59,17,-42
1,0,4,6,3,93,13,-80
2,0,2,0,5,234,11,-223
3,0,6,1,3,26,14,-12
1,0,0,1,3,93,37,-56
1,1,0,0,3,51,69,18
3,0,2,4,5,6,17,11
3,0,3,1,3,103,4,-99
1,0,2,0,5,28,66,38
3,0,6,1,3,9,50,41
3,1,1,0,3,88,6,-82
3,1,0,1,3,53,20,-33
1,0,0,7,3,20,45,25
3,0,6,0,3,12,34,22
3,0,3,1,3,41,102,61
3,0,0,1,3,62,20,-42
3,1,0,0,3,193,79,-114
0,1,3,0,3,50,58,8
3,0,6,4,3,1,110,109
3,1,6,4,3,16,13,-3
1,0,0,1,3,78,4,-74
1,0,2,0,5,412,38,-374
2,0,1,0,3,39,59,20
3,1,7,6,3,9,5,-4
1,0,5,0,3,234,41,-193
1,0,3,1,3,162,103,-59
3,0,1,1,3,8,77,69
3,0,6,0,3,103,93,-10
2,0,3,6,3,63,49,-14
3,1,0,0,3,58,57,-1
2,0,2,1,5,118,7,-111
1,0,4,1,3,151,45,-106
3,0,2,2,5,40,2,-38
1,0,6,6,3,1,3,2
1,0,6,0,3,21,25,4
3,0,3,4,3,40,13,-27
1,0,1,0,3,5,66,61
2,0,0,6,3,14,24,10
3,0,2,1,5,140,137,-3
2,0,2,0,5,625,154,-471
1,0,0,0,3,204,97,-107
3,1,0,0,3,10,446,436
1,0,0,0,3,63,113,50
3,0,4,0,3,53,64,11
3,0,6,0,3,65,15,-50
3,1,0,7,3,9,7,-2
3,0,5,0,3,44,213,169
3,1,1,6,3,34,15,-19
3,0,4,1,3,57,109,52
3,0,0,1,3,138,46,-92
1,0,0,0,3,101,37,-64
1,0,3,1,3,78,138,60
1,0,3,0,3,11,54,43
3,0,5,2,3,15,23,8
3,1,0,0,3,53,392,339
1,0,5,0,3,57,13,-44
3,0,2,0,5,384,55,-329
3,1,3,1,3,56,50,-6
3,0,2,0,5,10,131,121
1,0,3,1,3,65,7,-58
3,1,0,6,3,76,23,-53
0,1,4,0,3,343,122,-221
1,0,6,1,3,3,164,161
3,0,6,6,3,30,2,-28
1,0,6,0,3,40,55,15
3,0,5,0,3,42,74,32
3,0,2,0,5,42,30,-12
1,0,3,0,3,117,61,-56
3,1,0,0,3,69,66,-3
3,0,2,0,5,75,9,-66
3,0,0,0,3,16,177,161
2,0,2,0,5,10,272,262
2,0,2,0,5,48,161,113
3,0,1,1,3,11,177,166
3,0,3,0,3,17,63,46
1,0,3,6,3,7,53,46
3,0,3,4,3,10,42,32
1,0,2,1,5,35,72,37
3,0,2,1,5,24,55,31
2,0,0,4,3,19,1,-18
3,1,0,0,3,403,82,-321
2,0,0,1,3,60,394,334
0,1,3,0,3,5,63,58
3,1,6,1,3,6,22,16
1,0,3,1,3,57,39,-18
3,1,0,0,3,85,16,-69
3,1,0,4,3,181,27,-154
3,0,6,3,3,2,58,56
2,0,3,0,3,146,99,-47
3,0,5,2,3,1,52,51
3,0,2,0,5,101,108,7
1,0,0,4,3,73,55,-18
2,0,3,0,3,456,88,-368
1,0,0,1,3,52,72,20
3,1,0,0,3,54,66,12
3,0,6,1,3,1,149,148
1,0,3,0,3,39,195,156
3,0,2,2,5,71,89,18
3,0,4,0,3,62,456,394
0,1,3,0,3,175,34,-141
3,0,2,0,5,101,11,-90
3,0,5,1,3,8,57,49
2,0,2,2,5,189,111,-78
1,0,0,0,3,61,37,-24
1,0,1,6,3,1,56,55
1,0,3,6,3,24,111,87
3,0,6,1,3,10,73,63
3,1,3,0,3,123,145,22
0,1,5,1,3,16,25,9
0,1,3,0,3,39,68,29
2,0,0,2,3,17,60,43
3,1,0,0,3,292,93,-199
1,0,6,1,3,31,6,-25
3,1,0,0,3,332,129,-203
1,0,6,0,3,30,17,-13
1,0,3,1,3,120,26,-94
3,0,5,1,3,24,5,-19
1,0,0,4,3,130,15,-115
2,0,0,4,3,4,28,24
1,0,6,2,3,15,31,16
3,0,1,0,3,55,96,41
1,0,2,0,5,27,95,68
2,0,2,1,5,68,21,-47
3,1,6,2,3,20,8,-12
3,1,0,4,3,49,7,-42
1,0,4,4,3,67,56,-11
3,0,6,4,3,9,46,37
3,1,7,5,3,3,8,5
2,0,0,0,3,108,26,-82
1,0,1,2,3,87,30,-57
3,1,6,2,3,17,33,16
3,0,6,1,3,85,24,-61
3,1,0,0,3,49,424,375
1,0,2,1,5,1,50,49
3,0,6,0,3,97,92,-5
1,0,0,1,3,103,162,59
3,0,4,4,3,32,40,8
3,1,3,1,3,102,39,-63
1,0,2,0,5,13,149,136
2,0,2,1,5,91,24,-67
1,0,0,0,3,66,97,31
3,1,0,0,3,16,120,104
3,0,0,0,3,49,122,73
3,1,7,5,3,7,4,-3
1,0,4,0,3,90,70,-20
2,0,2,3,5,13,64,51
3,0,2,3,5,21,3,-18
1,0,0,0,3,129,66,-63
3,0,3,7,3,12,244,232
3,0,6,3,3,6,19,13
1,0,3,1,3,65,47,-18
2,0,0,0,3,65,2,-63
2,0,3,0,3,93,105,12
3,0,2,0,5,196,37,-159
3,0,6,0,3,60,63,3
1,0,0,0,3,114,102,-12
1,0,0,4,3,77,23,-54
3,0,3,1,3,73,132,59
1,0,3,4,3,4,47,43
3,0,2,2,5,62,6,-56
3,0,1,0,3,103,4,-99
1,0,5,0,3,26,49,23
1,0,2,2,5,37,7,-30
3,1,1,0,3,7,85,78
3,1,0,0,3,217,38,-179
2,0,2,2,5,43,203,160
3,1,1,1,3,8,29,21
3,0,6,2,3,41,1,-40
1,1,0,1,3,171,85,-86
3,1,4,0,3,131,227,96
1,0,3,1,3,30,114,84
3,1,1,0,3,23,159,136
1,0,2,4,5,5,1,-4
3,1,3,1,3,137,65,-72
2,0,2,0,5,48,120,72
1,0,2,0,5,63,5,-58
1,0,5,4,3,19,7,-12
1,0,3,0,3,93,66,-27
3,1,0,0,3,129,89,-40
1,0,3,1,3,56,65,9
3,1,0,4,3,10,31,21
3,0,6,0,3,94,31,-63
1,0,0,0,3,176,68,-108
1,0,2,0,5,51,186,135
3,0,5,4,3,35,43,8
3,1,0,6,3,16,23,7
3,0,1,0,3,35,50,15
3,0,6,7,3,2,6,4
3,0,2,1,5,7,66,59
1,0,2,2,5,3,32,29
2,0,0,6,3,2,70,68
3,0,5,0,3,76,36,-40
2,0,3,6,3,4,104,100
1,0,2,0,5,73,3,-70
1,0,3,0,3,10,103,93
3,0,2,1,5,18,64,46
1,0,2,0,5,4,67,63
1,0,6,2,3,10,22,12
3,1,3,1,3,10,97,87
3,1,0,0,3,25,67,42
1,0,0,6,3,110,78,-32
3,1,0,1,3,87,17,-70
3,1,0,0,3,13,94,81
1,0,0,0,3,395,143,-252
2,0,0,0,3,63,38,-25
2,0,2,0,5,158,70,-88
3,1,0,1,3,8,31,23
1,0,4,1,3,103,68,-35
3,0,4,0,3,203,180,-23
3,0,3,1,3,401,115,-286
3,0,2,0,5,19,97,78
3,0,5,0,3,49,57,8
1,0,4,0,3,78,32,-46
3,0,0,0,3,45,112,67
1,0,3,0,3,16,202,186
0,1,5,0,3,65,38,-27
1,0,2,0,5,23,59,36
1,0,3,0,3,23,108,85
1,0,3,4,3,105,14,-91
3,0,3,1,3,100,36,-64
2,0,2,0,5,61,57,-4
1,0,3,0,3,19,392,373
3,1,4,0,3,10,50,40
1,0,6,1,3,18,24,6
1,0,3,0,3,75,42,-33
1,0,0,0,3,37,71,34
1,0,3,0,3,79,72,-7
1,1,0,1,3,297,60,-237
3,1,1,0,3,36,63,27
1,0,6,1,3,91,4,-87
3,1,3,6,3,96,55,-41
3,1,0,4,3,14,84,70
3,0,1,1,3,44,15,-29
3,1,0,4,3,43,54,11
3,0,5,1,3,128,6,-122
3,0,2,0,5,9,90,81
3,0,0,0,3,69,133,64
1,0,6,2,3,4,13,9
3,0,0,0,3,107,56,-51
3,0,0,0,3,582,15,-567
1,0,3,0,3,6,146,140
3,0,5,1,3,15,94,79
1,0,6,0,3,126,72,-54
3,1,3,1,3,126,542,416
3,0,3,0,3,49,19,-30
2,0,1,0,3,35,27,-8
3,0,4,0,3,51,128,77
1,0,3,1,3,101,94,-7
1,0,3,6,3,22,46,24
0,1,3,0,3,72,64,-8
0,1,5,1,3,26,8,-18
3,1,4,6,3,15,49,34
3,0,5,0,3,127,139,12
2,0,0,0,3,62,63,1
1,0,3,6,3,53,95,42
1,0,0,0,3,79,60,-19
2,0,2,0,5,144,17,-127
0,1,3,0,3,89,8,-81
1,0,3,0,3,75,77,2
1,0,4,0,3,103,97,-6
1,0,6,0,3,75,32,-43
3,0,2,0,5,21,37,16
1,0,0,0,3,206,52,-154
3,0,5,2,3,3,27,24
1,0,6,1,3,26,62,36
3,0,2,0,5,9,216,207
1,0,2,3,5,10,38,28
3,1,0,1,3,58,35,-23
1,0,2,0,5,73,22,-51
3,0,2,1,5,65,100,35
3,0,6,2,3,16,23,7
3,1,5,0,3,54,27,-27
1,0,2,3,5,21,6,-15
1,0,1,1,3,32,53,21
1,0,0,0,3,47,107,60
3,0,1,1,3,35,16,-19
2,0,3,0,3,134,100,-34
3,1,3,4,3,44,98,54
1,0,0,6,3,8,64,56
3,0,6,3,3,26,2,-24
3,1,0,1,3,10,78,68
1,0,0,0,3,138,38,-100
3,0,4,0,3,130,81,-49
3,0,2,0,5,103,188,85
3,1,0,0,3,44,90,46
3,1,0,1,3,135,275,140
3,0,5,1,3,45,17,-28
1,0,6,1,3,5,174,169
3,0,3,1,3,47,428,381
3,0,6,6,3,7,4,-3
3,1,1,1,3,43,10,-33
3,0,3,1,3,67,48,-19
3,0,6,0,3,73,42,-31
3,1,1,4,3,59,1,-58
3,0,5,0,3,150,43,-107
3,1,0,0,3,63,62,-1
3,0,2,0,5,107,44,-63
3,0,2,0,5,108,33,-75
1,0,0,1,3,11,117,106
3,0,6,0,3,34,39,5
3,0,3,0,3,288,78,-210
1,0,2,0,5,86,13,-73
1,0,3,1,3,83,66,-17
3,0,6,3,3,55,6,-49
3,0,6,2,3,50,4,-46
1,0,6,1,3,13,34,21
1,0,5,1,3,58,122,64
1,0,0,0,3,544,97,-447
1,0,0,4,3,25,60,35
3,1,5,0,3,20,32,12
2,0,2,0,5,67,176,109
3,0,0,0,3,97,64,-33
1,0,0,0,3,99,103,4
3,1,6,0,3,33,57,24
3,0,4,0,3,92,150,58
3,1,0,1,3,46,302,256
3,0,0,0,3,72,4,-68
2,0,3,1,3,113,48,-65
2,0,1,4,3,23,3,-20
1,0,3,0,3,32,70,38
3,1,4,0,3,123,175,52
3,0,3,0,3,76,52,-24
3,0,1,0,3,28,81,53
1,0,0,4,3,49,13,-36
3,0,2,0,5,8,92,84
1,0,2,2,5,5,35,30
3,1,1,1,3,43,61,18
3,0,4,1,3,42,70,28
1,0,3,6,3,96,4,-92
1,0,3,1,3,86,57,-29
1,1,0,0,3,59,113,54
3,0,2,0,5,62,179,117
3,0,5,1,3,37,16,-21
2,0,0,1,3,55,33,-22
3,0,4,0,3,9,26,17
1,0,3,0,3,415,53,-362
0,1,3,1,3,127,100,-27
1,0,3,0,3,74,129,55
1,0,1,2,3,40,11,-29
1,0,3,1,3,18,39,21
1,0,0,0,3,79,328,249
2,0,2,3,5,40,94,54
3,1,1,7,3,8,59,51
1,0,0,1,3,144,192,48
3,0,5,1,3,10,124,114
3,0,6,1,3,130,14,-116
2,0,3,6,3,498,167,-331
3,0,3,0,3,121,100,-21
3,0,2,2,5,65,82,17
0,1,3,1,3,80,37,-43
2,0,2,0,5,145,16,-129
1,0,2,3,5,70,1,-69
3,0,3,0,3,80,109,29
1,0,3,0,3,29,71,42
2,0,2,0,5,51,104,53
3,0,6,0,3,58,100,42
1,0,4,1,3,96,48,-48
3,0,0,1,3,120,61,-59
3,0,0,4,3,5,53,48
3,0,0,0,3,87,95,8
3,0,1,4,3,33,5,-28
1,0,3,0,3,56,96,40
1,0,0,1,3,30,56,26
1,0,0,0,3,188,288,100
3,0,1,1,3,8,64,56
1,0,6,0,3,75,66,-9
1,0,2,1,5,48,4,-44
1,0,6,1,3,2,35,33
3,0,2,1,5,74,9,-65
3,0,4,0,3,21,30,9
3,0,2,0,5,94,51,-43
3,0,2,2,5,28,1,-27
3,0,2,0,5,99,218,119
3,0,0,2,3,60,102,42
3,0,6,1,3,55,27,-28
1,0,0,0,3,89,95,6
2,0,2,0,5,78,77,-1
3,1,0,0,3,33,66,33
3,0,5,2,3,25,1,-24
1,1,0,1,3,147,114,-33
3,0,2,0,5,34,106,72
1,0,2,0,5,45,32,-13
3,0,5,0,3,38,68,30
3,0,2,0,5,86,20,-66
1,0,3,1,3,57,102,45
2,0,0,6,3,30,103,73
1,0,2,0,5,87,23,-64
3,0,0,1,3,104,14,-90
3,0,3,0,3,77,56,-21
1,0,0,4,3,43,14,-29
3,0,3,1,3,97,19,-78
3,0,2,0,5,433,70,-363
0,1,3,0,3,65,100,35
3,0,2,3,5,22,7,-15
3,0,2,0,5,51,27,-24
1,0,2,0,5,36,287,251
1,0,3,0,3,64,98,34
3,0,3,1,3,39,162,123
3,1,0,0,3,58,62,4
3,0,0,0,3,87,106,19
1,1,0,4,3,70,21,-49
2,0,0,0,3,73,31,-42
2,0,0,1,3,77,49,-28
3,0,5,2,3,100,15,-85
3,0,0,0,3,46,49,3
3,0,6,1,3,40,35,-5
3,0,2,1,5,43,4,-39
3,1,0,1,3,154,97,-57
1,1,0,1,3,113,116,3
3,0,2,0,5,32,240,208
1,0,1,6,3,5,20,15
2,0,3,2,3,48,11,-37
1,0,2,3,5,37,62,25
2,0,2,0,5,59,9,-50
3,1,0,4,3,203,79,-124
3,1,4,0,3,35,46,11
2,0,0,1,3,80,36,-44
3,1,5,1,3,30,13,-17
2,0,2,0,5,75,53,-22
3,0,1,0,3,48,111,63
3,0,2,0,5,6,53,47
1,0,2,6,5,10,13,3
3,0,6,2,3,82,35,-47
2,0,2,1,5,478,147,-331
3,1,0,0,3,66,59,-7
3,0,3,1,3,161,13,-148
2,0,0,7,3,72,30,-42
2,0,3,0,3,61,122,61
3,1,0,1,3,12,115,103
0,1,3,0,3,83,30,-53
3,1,0,0,3,50,215,165
3,0,6,2,3,22,34,12
3,1,3,0,3,118,70,-48
1,0,3,1,3,13,112,99
3,0,0,0,3,133,74,-59
3,0,3,1,3,29,36,7
2,0,3,6,3,84,111,27
1,0,2,0,5,59,58,-1
3,0,2,0,5,8,58,50
3,0,1,1,3,8,124,116
2,0,1,0,3,16,39,23
2,0,2,1,5,32,78,46
2,0,0,6,3,16,49,33
1,0,3,0,3,63,73,10
3,0,2,2,5,179,22,-157
3,0,6,3,3,123,17,-106
2,0,0,1,3,26,78,52
3,1,0,0,3,548,34,-514
1,0,0,0,3,109,180,71
2,0,0,4,3,110,72,-38
3,0,5,1,3,84,24,-60
3,1,1,0,3,40,25,-15
3,0,6,1,3,9,166,157
1,0,3,0,3,110,288,178
3,0,2,2,5,110,3,-107
3,0,6,0,3,101,106,5
1,0,2,0,5,1,83,82
1,0,6,0,3,63,48,-15
1,0,6,2,3,6,51,45
3,0,4,1,3,60,96,36
3,0,0,1,3,137,67,-70
3,0,0,0,3,129,403,274
1,0,3,1,3,84,37,-47
1,0,3,1,3,81,48,-33
1,0,1,1,3,6,47,41
2,0,3,1,3,38,85,47
1,0,3,0,3,327,55,-272
1,0,0,1,3,59,66,7
3,0,0,4,3,42,22,-20
1,0,6,2,3,18,37,19
1,0,2,1,5,5,230,225
2,0,0,0,3,127,394,267
3,0,0,0,3,44,209,165
1,0,3,6,3,86,34,-52
2,0,0,0,3,41,86,45
2,0,3,0,3,60,46,-14
3,1,0,0,3,245,52,-193
1,0,0,1,3,51,16,-35
3,0,3,4,3,120,18,-102
1,0,3,0,3,173,92,-81
2,0,2,2,5,62,3,-59
1,1,0,1,3,64,90,26
1,0,0,1,3,81,90,9
1,0,2,4,5,5,17,12
3,0,6,2,3,40,13,-27
1,0,3,4,3,115,77,-38
3,0,6,1,3,151,14,-137
3,1,0,0,3,99,47,-52
3,0,0,0,3,74,166,92
3,1,0,0,3,46,134,88
3,0,2,0,5,92,41,-51
2,0,0,0,3,44,35,-9
3,0,6,1,3,44,14,-30
3,1,0,1,3,14,60,46
2,0,2,1,5,67,203,136
2,0,3,0,3,90,141,51
3,0,6,0,3,28,13,-15
1,0,2,0,5,166,29,-137
3,1,7,5,3,6,8,2
3,0,1,1,3,8,49,41
3,0,4,2,3,35,3,-32
3,0,0,1,3,92,44,-48
3,0,6,1,3,57,11,-46
1,0,3,1,3,177,60,-117
2,0,0,4,3,156,116,-40
3,1,4,4,3,72,66,-6
1,0,1,0,3,5,106,101
3,0,2,0,5,101,107,6
1,0,0,0,3,49,517,468
3,0,4,0,3,49,140,91
1,0,0,1,3,94,70,-24
1,0,0,4,3,35,77,42
3,0,5,2,3,41,24,-17
3,0,2,0,5,54,78,24
1,0,6,1,3,62,15,-47
3,0,1,1,3,96,21,-75
2,0,0,0,3,36,218,182
3,0,6,2,3,26,19,-7
3,1,3,1,3,126,88,-38
1,0,0,0,3,53,72,19
3,0,6,1,3,14,43,29
3,0,5,1,3,55,20,-35
3,0,2,0,5,206,26,-180
3,0,6,3,3,97,4,-93
3,0,3,0,3,49,61,12
3,0,2,2,5,109,43,-66
3,0,6,2,3,31,239,208
1,0,0,0,3,78,153,75
2,0,3,4,3,30,22,-8
3,0,6,2,3,34,3,-31
2,0,2,1,5,43,54,11
0,1,5,0,3,25,34,9
1,0,3,1,3,123,4,-119
1,0,0,0,3,49,45,-4
1,0,2,0,5,41,28,-13
1,0,3,6,3,59,66,7
1,0,1,1,3,26,45,19
3,1,0,0,3,193,171,-22
3,1,0,0,3,28,58,30
0,1,3,4,3,13,25,12
3,0,4,0,3,77,108,31
3,1,3,7,3,39,26,-13
3,1,0,6,3,93,187,94
3,0,5,2,3,82,27,-55
1,0,6,1,3,69,38,-31
3,1,0,1,3,63,38,-25
3,0,6,2,3,41,24,-17
3,0,2,0,5,34,104,70
3,1,4,0,3,26,21,-5
3,0,3,5,3,60,193,133
1,0,3,0,3,306,67,-239
1,0,0,0,3,48,96,48
2,0,2,1,5,87,42,-45
2,0,3,1,3,91,77,-14
1,0,5,0,3,99,85,-14
3,0,3,0,3,79,105,26
1,0,2,0,5,96,87,-9
3,1,0,1,3,9,116,107
1,0,0,4,3,23,45,22
2,0,0,4,3,95,283,188
3,0,0,0,3,29,78,49
1,0,5,0,3,30,44,14
1,0,3,0,3,83,57,-26
3,0,5,0,3,46,124,78
3,0,1,7,3,8,6,-2
3,0,1,1,3,16,92,76
1,0,3,0,3,5,81,76
3,0,2,0,5,53,49,-4
1,0,5,0,3,16,41,25
3,0,6,1,3,2,26,24
3,0,6,0,3,224,16,-208
0,1,3,1,3,60,41,-19
1,0,5,4,3,55,54,-1
3,0,2,0,5,141,7,-134
3,0,6,0,3,55,87,32
3,0,0,1,3,52,84,32
3,1,3,0,3,103,409,306
3,1,3,4,3,70,1,-69
3,0,0,1,3,68,29,-39
1,0,0,0,3,83,38,-45
1,0,0,1,3,80,3,-77
3,1,1,4,3,41,36,-5
2,0,2,7,5,2,6,4
3,1,3,6,3,4,24,20
1,0,2,1,5,59,8,-51
2,0,0,4,3,26,38,12
1,0,0,0,3,77,64,-13
3,0,6,2,3,33,8,-25
3,0,6,4,3,3,23,20
3,0,4,0,3,57,1,-56
2,0,1,1,3,45,1,-44
1,0,0,4,3,57,26,-31
3,1,0,0,3,57,1059,1002
3,0,4,1,3,62,22,-40
3,1,0,1,3,80,11,-69
3,1,4,1,3,80,64,-16
3,0,2,2,5,38,2,-36
3,0,6,2,3,4,19,15
3,0,0,0,3,108,43,-65
2,0,0,0,3,272,123,-149
3,1,1,0,3,43,40,-3
3,1,4,7,3,64,17,-47
2,0,3,0,3,92,88,-4
1,0,4,7,5,48,7,-41
3,0,2,2,5,66,86,20
1,0,5,4,3,78,3,-75
3,0,2,0,5,84,135,51
2,0,2,0,5,92,59,-33
1,0,1,1,3,54,125,71
3,0,2,1,5,51,28,-23
3,0,3,0,3,19,257,238
3,0,6,1,3,41,34,-7
3,0,0,1,3,148,90,-58
2,0,3,0,3,29,5,-24
3,1,6,0,3,74,25,-49
3,0,2,0,5,121,108,-13
3,0,2,0,5,54,46,-8
2,0,1,0,3,164,29,-135
3,0,0,1,3,291,72,-219
3,0,4,0,3,50,17,-33
3,1,3,6,3,6,46,40
3,0,0,1,3,28,22,-6
1,0,2,1,5,7,112,105
1,0,3,1,3,39,204,165
3,1,0,4,3,82,259,177
1,0,0,0,3,748,46,-702
1,0,2,3,5,8,13,5
3,0,5,0,3,59,57,-2
3,0,2,1,5,6,66,60
2,0,2,0,5,3,106,103
3,0,4,1,3,110,168,58
1,0,3,1,3,61,11,-50
3,0,4,1,3,33,82,49
3,0,5,1,3,7,66,59
1,0,1,0,3,230,48,-182
3,1,0,1,3,358,14,-344
3,0,2,1,5,63,20,-43
1,0,0,0,3,87,46,-41
3,0,0,1,3,47,474,427
1,0,4,1,3,9,62,53
3,0,0,0,3,118,12,-106
3,1,5,2,3,8,10,2
3,1,1,4,3,42,1,-41
1,0,0,0,3,930,78,-852
3,0,3,1,3,106,70,-36
3,0,1,0,3,92,103,11
3,0,5,3,3,36,1,-35
3,1,0,0,3,60,686,626
3,0,6,0,3,67,203,136
3,1,1,4,3,72,14,-58
3,1,0,4,3,41,7,-34
1,0,2,2,5,16,124,108
1,0,6,2,3,151,23,-128
1,0,3,1,3,163,96,-67
3,0,6,1,3,28,139,111
3,0,5,0,3,37,57,20
3,1,1,1,3,15,53,38
3,0,0,0,3,112,108,-4
1,0,0,6,3,44,1,-43
3,0,6,0,3,75,34,-41
3,0,6,1,3,32,45,13
3,1,3,0,3,113,92,-21
3,0,5,1,3,59,37,-22
1,0,1,0,3,126,99,-27
2,0,2,0,5,82,163,81
3,1,0,0,3,123,138,15
1,0,5,1,3,46,1,-45
3,0,6,0,3,78,20,-58
3,0,3,0,3,238,45,-193
3,0,6,0,3,21,141,120
3,0,6,0,3,78,79,1
1,0,5,1,3,45,16,-29
3,1,7,5,3,2,9,7
1,0,3,0,3,95,40,-55
3,1,1,1,3,18,10,-8
1,0,6,0,3,17,32,15
3,0,1,7,3,3,7,4
3,0,6,0,3,22,121,99
3,0,2,4,5,12,3,-9
1,0,0,1,3,94,71,-23
2,0,3,1,3,1,63,62
1,0,4,1,3,80,5,-75
3,0,0,1,3,58,21,-37
1,0,6,7,3,3,4,1
1,0,0,0,3,82,34,-48
1,0,1,0,3,70,80,10
1,0,0,1,3,70,98,28
3,0,1,1,3,20,62,42
3,0,3,0,3,1032,155,-877
3,0,0,0,3,74,49,-25
3,0,2,1,5,96,12,-84
2,0,2,0,5,48,3,-45
2,0,1,4,3,92,21,-71
3,1,3,0,3,28,185,157
3,0,6,1,3,101,3,-98
3,0,2,0,5,65,72,7
3,0,2,0,5,133,11,-122
3,0,0,0,3,170,147,-23
1,0,5,0,3,28,98,70
2,0,3,1,3,13,101,88
1,0,1,2,3,37,10,-27
3,1,0,4,3,74,84,10
1,0,6,0,3,24,94,70
3,1,0,6,3,45,61,16
1,0,0,6,3,16,34,18
1,0,1,0,3,24,77,53
1,1,0,0,3,70,121,51
1,0,4,1,3,122,17,-105
1,0,0,0,3,128,79,-49
3,0,3,1,3,20,56,36
3,0,1,0,3,66,196,130
1,0,2,0,5,49,281,232
3,1,1,0,3,30,36,6
3,0,2,1,5,7,53,46
1,0,0,0,3,60,129,69
3,1,0,1,3,12,107,95
1,0,2,2,5,19,13,-6
0,1,5,1,3,34,118,84
1,0,2,1,5,26,82,56
2,0,0,0,3,28,97,69
3,1,5,1,3,61,18,-43
3,0,1,0,3,389,61,-328
2,0,0,4,3,95,54,-41
3,0,2,0,5,74,175,101
3,0,2,2,5,6,35,29
1,0,2,2,5,2,33,31
3,0,1,1,3,46,256,210
1,0,0,0,3,66,57,-9
3,1,3,1,3,89,111,22
3,1,0,1,3,31,210,179
3,1,0,0,3,830,133,-697
1,0,3,4,3,33,57,24
3,0,2,0,5,27,35,8
1,0,6,6,3,5,8,3
3,0,6,1,3,26,10,-16
3,0,1,4,3,11,32,21
3,0,6,2,3,7,53,46
3,0,0,2,3,67,58,-9
3,1,6,0,3,61,52,-9
1,0,0,0,3,38,95,57
1,0,1,1,3,84,37,-47
3,0,2,1,5,14,77,63
1,0,6,2,3,4,24,20
3,1,3,0,3,98,271,173
1,0,6,0,3,22,51,29
3,1,0,1,3,240,12,-228
3,0,6,0,3,28,73,45
1,0,5,4,3,14,7,-7
2,0,2,0,5,66,116,50
3,0,2,0,5,104,119,15
3,1,1,1,3,19,11,-8
3,0,3,6,3,99,83,-16
2,0,2,0,5,119,25,-94
2,0,2,4,5,25,12,-13
3,1,0,4,3,67,17,-50
3,0,2,2,5,74,87,13
3,0,2,4,5,24,15,-9
1,0,0,4,3,72,172,100
3,1,3,6,3,690,19,-671
3,0,1,0,3,13,102,89
3,1,3,0,3,115,327,212
1,0,0,0,3,67,68,1
3,0,2,1,5,23,84,61
1,0,3,1,3,114,46,-68
1,0,3,0,3,112,59,-53
3,0,2,0,5,167,62,-105
3,0,2,0,5,36,81,45
3,0,5,3,3,25,24,-1
3,0,0,0,3,266,72,-194
1,0,5,7,5,24,12,-12
2,0,0,1,3,144,18,-126
3,0,5,2,3,19,61,42
3,0,2,0,5,96,40,-56
2,0,3,0,3,64,77,13
3,0,6,0,3,41,61,20
3,0,2,0,5,21,72,51
1,0,5,1,3,55,117,62
3,0,6,0,3,21,11,-10
2,0,3,7,3,130,167,37
2,0,3,0,3,73,65,-8
3,0,0,1,3,15,40,25
1,0,6,4,3,9,4,-5
1,0,5,0,3,80,76,-4
2,0,0,4,3,54,30,-24
1,0,6,0,3,56,162,106
1,0,0,0,3,179,84,-95
3,0,1,1,3,4,48,44
2,0,2,3,5,6,19,13
1,0,1,1,3,35,51,16
2,0,0,4,3,101,95,-6
1,0,3,4,3,50,117,67
1,0,6,0,3,45,18,-27
2,0,2,0,5,69,45,-24
3,1,3,4,3,40,42,2
3,0,2,1,5,15,105,90
3,0,0,4,3,20,13,-7
3,1,6,1,3,11,34,23
2,0,2,2,5,141,46,-95
3,1,0,0,3,93,55,-38
2,0,3,1,3,4,189,185
1,0,0,1,3,97,31,-66
3,0,2,1,5,23,134,111
3,0,6,3,3,23,3,-20
1,0,4,2,3,151,140,-11
1,0,6,6,3,1,6,5
3,0,4,2,3,35,36,1
2,0,2,0,5,111,6,-105
3,0,4,1,3,136,17,-119
1,0,6,1,3,29,31,2
3,0,6,1,3,49,40,-9
3,1,4,0,3,74,135,61
1,0,0,0,3,86,67,-19
1,0,5,0,3,31,32,1
2,0,0,1,3,30,112,82
3,0,0,4,3,28,15,-13
3,1,7,5,3,9,4,-5
2,0,0,0,3,145,134,-11
3,0,6,1,3,122,91,-31
1,0,4,0,3,50,28,-22
1,0,0,6,3,47,60,13
1,0,2,1,5,70,20,-50
3,0,0,4,3,80,87,7
3,1,0,4,3,7,154,147
0,1,3,0,3,33,142,109
3,0,2,2,5,5,28,23
3,1,4,1,3,160,2,-158
3,0,5,0,3,21,29,8
3,1,0,1,3,25,134,109
3,1,1,0,3,18,20,2
3,0,0,1,3,33,7,-26
3,1,6,1,3,4,37,33
3,0,3,0,3,79,94,15
3,0,2,2,5,57,1,-56
2,0,0,0,3,12,216,204
3,0,2,2,5,79,7,-72
3,0,4,0,3,66,1109,1043
1,0,0,0,3,86,104,18
1,0,0,6,3,7,82,75
1,0,3,0,3,91,56,-35
3,0,6,2,3,9,31,22
1,0,3,1,3,46,104,58
3,0,2,1,5,117,7,-110
3,1,0,0,3,98,36,-62
1,0,3,0,3,80,41,-39
1,0,2,0,5,173,223,50
3,0,2,1,5,28,148,120
2,0,0,1,3,152,104,-48
2,0,3,0,3,113,74,-39
3,0,3,4,3,112,54,-58
3,0,2,0,5,57,24,-33
3,0,0,0,3,60,57,-3
3,1,0,0,3,50,98,48
1,0,5,1,3,6,70,64
1,0,0,0,3,83,74,-9
3,1,0,0,3,135,38,-97
3,0,2,3,5,4,16,12
3,1,0,0,3,57,37,-20
1,0,4,1,3,61,137,76
3,1,1,7,3,9,25,16
1,0,2,1,5,116,29,-87
1,0,3,0,3,82,129,47
3,0,0,0,3,53,319,266
3,1,4,1,3,84,41,-43
3,0,3,0,3,88,227,139
3,0,6,1,3,6,169,163
1,0,0,0,3,70,91,21
3,1,0,0,3,83,66,-17
3,0,2,2,5,14,64,50
3,1,0,0,3,75,105,30
3,0,5,0,3,44,66,22
3,0,2,0,5,162,106,-56
3,1,0,0,3,92,83,-9
1,0,2,0,5,78,5,-73
3,0,2,0,5,6,105,99
3,0,5,0,3,76,41,-35
1,0,2,0,5,105,56,-49
1,0,2,1,5,10,187,177
3,0,6,0,3,54,104,50
3,0,1,4,3,3,16,13
1,0,1,4,3,10,31,21
0,1,5,0,3,33,30,-3
1,0,6,0,3,35,65,30
3,0,6,2,3,12,18,6
1,0,0,0,3,96,109,13
1,0,0,0,3,215,76,-139
3,0,3,0,3,53,104,51
3,0,3,0,3,136,138,2
3,0,0,0,3,61,58,-3
1,0,3,0,3,135,160,25
1,0,4,1,3,100,28,-72
3,0,4,4,3,31,1,-30
2,0,2,3,5,15,2,-13
3,0,4,2,3,43,141,98
1,0,0,6,3,24,28,4
1,0,2,0,5,32,116,84
0,1,5,1,3,123,20,-103
1,0,0,0,3,67,45,-22
0,1,3,1,3,68,71,3
2,0,2,0,5,661,114,-547
1,0,4,1,3,36,111,75
1,0,6,2,3,35,1,-34
3,0,5,1,3,40,30,-10
0,1,3,1,3,46,13,-33
3,1,0,0,3,160,340,180
2,0,0,0,3,87,281,194
2,0,2,0,5,46,103,57
3,0,5,2,3,6,45,39
3,0,2,1,5,97,24,-73
1,0,3,4,3,84,17,-67
3,0,2,1,5,29,111,82
1,0,6,2,3,35,7,-28
2,0,0,4,3,32,46,14
1,0,0,0,3,104,163,59
0,1,5,4,3,14,28,14
3,1,0,0,3,37,59,22
2,0,2,2,5,25,63,38
3,0,6,0,3,26,40,14
1,0,3,0,3,5,349,344
3,0,1,1,3,55,73,18
1,0,6,4,3,17,6,-11
3,1,4,4,3,17,71,54
1,0,6,0,3,35,41,6
3,1,0,1,3,315,34,-281
3,0,5,0,3,3,111,108
1,0,2,0,5,111,112,1
3,1,0,1,3,174,35,-139
1,0,2,0,5,213,98,-115
3,0,0,0,3,18,87,69
3,0,6,0,3,99,54,-45
3,0,0,4,3,74,109,35
3,1,3,0,3,142,100,-42
1,0,0,0,3,49,50,1
1,0,6,1,3,9,42,33
3,0,2,0,5,116,77,-39
1,0,0,6,3,99,21,-78
3,0,4,4,3,16,60,44
3,0,2,3,5,13,2,-11
3,1,0,0,3,27,63,36
3,0,6,1,3,68,21,-47
3,0,0,0,3,446,38,-408
3,0,6,0,3,75,81,6
2,0,3,0,3,318,27,-291
2,0,0,1,3,147,61,-86
2,0,0,1,3,67,42,-25
3,0,0,1,3,91,41,-50
3,0,6,4,3,2,13,11
1,0,6,0,3,96,46,-50
1,0,4,0,3,240,95,-145
1,0,5,0,3,15,93,78
3,1,0,0,3,93,115,22
3,0,0,6,3,27,67,40
3,1,1,0,3,29,43,14
3,0,3,4,3,61,18,-43
3,0,2,0,5,154,21,-133
3,1,6,2,3,8,188,180
2,0,2,2,5,62,10,-52
3,0,0,0,3,103,111,8
3,0,3,0,3,50,44,-6
1,0,0,6,3,89,59,-30
3,1,0,6,3,16,15,-1
3,0,0,1,3,20,61,41
1,0,4,1,3,21,95,74
3,0,2,1,5,82,234,152
1,0,3,1,3,72,120,48
3,0,6,0,3,47,78,31
2,0,2,0,5,194,23,-171
3,1,0,1,3,13,172,159
3,0,0,0,3,26,115,89
2,0,2,0,5,103,105,2
3,0,5,3,3,2,96,94
2,0,0,0,3,165,116,-49
3,1,0,1,3,31,102,71
3,0,6,0,3,38,24,-14
3,1,0,0,3,52,970,918
1,0,2,1,5,38,95,57
1,0,6,1,3,85,19,-66
3,1,0,6,3,23,27,4
3,1,4,1,3,87,126,39
1,0,2,0,5,103,37,-66
3,0,0,0,3,109,91,-18
3,1,0,0,3,132,78,-54
1,0,0,1,3,1360,27,-1333
3,1,0,1,3,102,61,-41
1,0,2,2,5,38,76,38
3,1,3,1,3,58,72,14
1,0,5,0,3,46,49,3
2,0,2,0,5,22,86,64
3,0,6,1,3,68,22,-46
0,1,3,1,3,38,54,16
2,0,1,0,3,119,99,-20
3,0,5,0,3,70,74,4
3,0,6,0,3,364,53,-311
3,0,3,0,3,85,512,427
1,0,6,7,3,8,5,-3
2,0,2,1,5,261,33,-228
1,0,5,0,3,12,42,30
1,1,0,4,3,63,113,50
0,1,5,2,3,11,8,-3
1,0,3,0,3,43,175,132
2,0,0,4,3,83,35,-48
1,0,0,0,3,44,137,93
3,0,5,0,3,156,21,-135
3,0,5,1,3,3,76,73
0,1,5,2,3,46,7,-39
2,0,3,2,3,12,44,32
3,0,1,0,3,91,63,-28
3,0,4,0,3,110,130,20
1,0,3,0,3,13,51,38
3,0,3,1,3,32,60,28
3,0,0,0,3,62,327,265
3,1,4,4,3,22,37,15
3,1,1,0,3,30,44,14
3,1,1,4,3,47,7,-40
3,0,6,0,3,39,57,18
3,0,6,3,3,12,9,-3
1,0,4,0,3,105,357,252
3,1,5,0,3,96,56,-40
3,1,1,4,3,7,45,38
3,1,1,0,3,99,12,-87
3,0,0,1,3,17,77,60
3,1,4,1,3,174,99,-75
0,1,3,0,3,47,49,2
3,1,0,4,3,51,12,-39
1,0,3,6,3,176,132,-44
3,1,3,0,3,9,159,150
1,0,3,1,3,84,22,-62
1,0,2,4,5,4,46,42
3,1,3,6,3,4,57,53
1,0,4,4,3,12,39,27
3,0,0,7,3,137,87,-50
3,0,2,1,5,43,22,-21
1,0,2,0,5,87,120,33
2,0,3,0,3,15,27,12
3,0,5,2,3,26,27,1
3,0,2,2,5,20,17,-3
3,0,1,1,3,7,45,38
3,0,0,4,3,90,42,-48
3,0,6,0,3,61,89,28
1,0,0,4,3,29,93,64
3,0,0,0,3,80,58,-22
3,0,0,0,3,99,151,52
3,0,2,0,5,182,54,-128
3,0,2,1,5,1,177,176
1,0,0,0,3,60,36,-24
3,0,6,7,3,17,5,-12
3,1,0,0,3,70,60,-10
1,0,5,1,3,15,94,79
3,0,0,1,3,29,46,17
1,0,0,4,3,35,230,195
2,0,3,7,3,68,49,-19
3,0,4,2,3,47,54,7
3,1,3,0,3,9,39,30
2,0,0,0,3,171,173,2
2,0,2,1,5,28,163,135
3,0,5,0,3,80,9,-71
1,0,4,0,3,76,169,93
2,0,0,1,3,236,16,-220
3,1,1,0,3,12,84,72
1,0,4,0,3,49,94,45
3,0,3,1,3,108,63,-45
3,0,6,4,3,7,34,27
1,0,6,1,3,19,37,18
1,0,6,0,3,52,40,-12
1,0,3,7,3,91,68,-23
3,0,0,0,3,115,100,-15
3,0,1,0,3,41,57,16
1,0,6,0,3,39,22,-17
3,0,1,0,3,83,93,10
2,0,0,0,3,62,67,5
3,0,5,2,3,9,33,24
1,0,0,4,3,113,20,-93
3,0,2,0,5,2,138,136
1,0,2,1,5,213,14,-199
3,1,5,0,3,75,18,-57
3,0,2,1,5,70,3,-67
2,0,3,0,3,66,9,-57
0,1,3,1,3,111,66,-45
3,0,2,1,5,39,6,-33
2,0,0,0,3,144,56,-88
3,0,1,1,3,87,59,-28
3,0,4,0,3,129,562,433
3,0,1,6,3,25,42,17
1,0,0,0,3,168,90,-78
1,0,4,2,3,55,58,3
1,0,0,0,3,1267,78,-1189
1,0,5,1,3,67,10,-57
3,0,6,1,3,10,58,48
3,1,4,4,3,38,34,-4
3,0,2,0,5,8,86,78
3,1,0,4,3,808,86,-722
1,0,0,0,3,111,72,-39
3,1,5,2,3,21,2,-19
3,0,1,0,3,87,55,-32
1,0,2,0,5,157,65,-92
3,0,6,0,3,60,80,20
2,0,0,0,3,64,30,-34
3,1,0,0,3,56,1217,1161
2,0,3,0,3,134,88,-46
1,0,3,1,3,12,165,153
1,0,2,2,5,283,67,-216
3,0,2,0,5,112,69,-43
1,0,1,4,3,81,13,-68
3,1,1,4,3,284,54,-230
1,0,4,4,3,95,42,-53
3,0,6,0,3,41,30,-11
1,0,4,1,3,117,39,-78
2,0,0,0,3,491,62,-429
1,0,3,7,3,84,6,-78
3,0,3,4,3,106,114,8
3,0,2,1,5,31,219,188
3,0,2,0,5,160,31,-129
1,0,4,4,3,44,7,-37
1,0,3,4,3,34,340,306
2,0,2,0,5,194,19,-175
3,0,0,1,3,31,9,-22
3,0,6,0,3,67,77,10
3,0,4,0,3,362,86,-276
3,0,6,1,3,76,9,-67
2,0,2,0,5,94,36,-58
2,0,2,0,5,156,147,-9
1,0,6,1,3,20,22,2
3,0,3,4,3,14,4,-10
1,0,3,0,3,168,57,-111
3,0,2,0,5,3,101,98
2,0,0,0,3,58,183,125
3,1,1,0,3,80,18,-62
3,0,6,2,3,38,77,39
3,0,6,2,3,10,24,14
3,1,3,0,3,330,19,-311
3,0,6,7,3,3,1,-2
3,0,6,4,3,38,9,-29
2,0,3,1,3,38,64,26
3,1,0,7,3,10,43,33
2,0,0,0,3,866,114,-752
3,1,0,1,3,80,26,-54
1,0,3,0,3,432,82,-350
3,0,6,0,3,28,17,-11
2,0,2,2,5,43,5,-38
3,0,3,0,3,211,219,8
3,0,3,6,3,29,27,-2
3,1,1,0,3,45,8,-37
0,1,3,0,3,42,141,99
0,1,5,1,3,30,11,-19
3,0,0,1,3,49,37,-12
2,0,0,0,3,72,79,7
3,0,2,2,5,114,9,-105
3,0,0,0,3,36,70,34
1,0,3,7,3,61,48,-13
2,0,2,0,5,11,272,261
1,0,0,0,3,124,74,-50
3,0,3,4,3,117,104,-13
3,0,0,6,3,14,41,27
1,0,3,0,3,48,80,32
2,0,0,6,3,38,40,2
2,0,3,7,3,113,60,-53
3,0,2,0,5,85,46,-39
3,0,1,0,3,107,103,-4
1,0,5,1,3,30,19,-11
3,0,2,1,5,14,58,44
3,0,5,1,3,6,70,64
3,0,2,1,5,146,2,-144
3,0,3,1,3,55,19,-36
3,0,6,7,3,2,4,2
2,0,3,1,3,69,100,31
2,0,2,0,5,23,70,47
1,0,6,0,3,72,13,-59
3,1,0,1,3,103,140,37
3,0,2,3,5,10,5,-5
3,0,3,0,3,26,108,82
3,1,3,0,3,108,94,-14
3,0,3,1,3,92,154,62
1,0,1,0,3,21,231,210
3,0,4,0,3,61,51,-10
1,0,0,0,3,117,244,127
1,0,4,2,3,374,44,-330
3,0,6,0,3,16,50,34
3,1,4,6,3,40,7,-33
3,0,6,2,3,6,27,21
1,0,4,0,3,66,84,18
3,1,7,6,3,5,4,-1
3,0,6,4,3,40,2,-38
1,0,6,2,3,3,96,93
2,0,2,0,5,90,92,2
3,1,3,0,3,102,339,237
3,0,6,2,3,24,2,-22
1,0,4,0,3,125,32,-93
3,0,1,0,3,393,654,261
1,0,1,0,3,257,99,-158
3,0,0,6,3,41,24,-17
1,0,0,0,3,33,64,31
1,0,1,1,3,81,13,-68
3,0,0,0,3,53,32,-21
1,0,6,2,3,3,17,14
1,0,0,0,3,44,61,17
3,0,2,1,5,389,39,-350
0,1,3,0,3,59,135,76
2,0,3,1,3,147,34,-113
3,1,1,1,3,54,16,-38
1,0,2,2,5,8,23,15
2,0,2,1,5,168,35,-133
3,0,1,0,3,35,18,-17
2,0,0,0,3,161,63,-98
2,0,3,0,3,40,91,51
2,0,2,0,5,285,87,-198
1,0,1,1,3,9,59,50
3,0,6,0,3,92,66,-26
3,0,2,1,5,84,201,117
3,0,0,0,3,131,34,-97
1,0,6,1,3,12,67,55
1,0,5,0,3,41,24,-17
1,0,4,1,3,59,28,-31
2,0,2,0,5,112,102,-10
3,0,2,1,5,11,53,42
1,0,3,1,3,106,60,-46
1,0,6,2,3,4,100,96
1,0,2,1,5,21,67,46
3,0,3,1,3,98,65,-33
1,0,3,5,3,97,27,-70
1,0,1,0,3,18,154,136
1,0,1,4,3,55,23,-32
3,0,6,0,3,90,60,-30
1,0,3,1,3,60,29,-31
1,0,4,4,3,16,15,-1
3,1,0,1,3,50,14,-36
3,1,4,0,3,61,13,-48
1,0,6,0,3,95,53,-42
3,0,6,1,3,147,5,-142
3,0,0,0,3,78,67,-11
1,0,0,6,3,14,56,42
3,0,3,0,3,88,128,40
1,0,4,1,3,12,187,175
1,0,3,4,3,128,110,-18
3,0,2,1,5,85,15,-70
3,1,4,0,3,79,18,-61
1,0,6,1,3,121,29,-92
3,0,2,1,5,87,86,-1
2,0,3,2,3,16,7,-9
1,0,0,0,3,108,84,-24
3,1,6,2,3,14,5,-9
3,0,2,0,5,296,94,-202
3,0,1,0,3,165,61,-104
1,0,1,0,3,36,655,619
3,0,0,7,3,84,167,83
2,0,2,0,5,69,108,39
3,0,2,3,5,27,9,-18
3,0,2,0,5,2,126,124
3,0,3,1,3,56,53,-3
1,0,3,1,3,72,105,33
1,0,5,1,3,56,25,-31
3,1,0,1,3,12,204,192
3,0,6,1,3,52,85,33
1,0,0,0,3,90,134,44
2,0,2,0,5,141,40,-101
1,0,4,6,3,18,15,-3
3,0,3,0,3,47,285,238
2,0,2,6,5,1,8,7
1,0,2,0,5,31,106,75
1,1,0,0,3,164,146,-18
0,1,5,4,3,2,8,6
1,0,0,1,3,138,69,-69
3,0,2,1,5,9,38,29
3,1,0,1,3,266,13,-253
3,1,0,0,3,86,31,-55
0,1,5,7,5,63,7,-56
3,0,6,6,3,32,3,-29
3,1,0,4,3,16,29,13
3,1,7,5,3,5,1,-4
1,0,5,0,3,7,64,57
3,0,0,1,3,38,82,44
3,0,1,4,3,17,13,-4
1,0,6,1,3,59,6,-53
1,0,0,1,3,52,21,-31
3,0,2,1,5,42,78,36
1,0,0,1,3,77,27,-50
1,0,0,0,3,122,107,-15
1,0,1,0,3,47,64,17
3,0,2,1,5,65,3,-62
3,0,3,0,3,6,109,103
3,0,3,1,3,17,78,61
2,0,0,1,3,23,81,58
2,0,2,0,5,66,102,36
1,0,6,0,3,128,36,-92
3,1,4,1,3,16,419,403
2,0,0,0,3,145,61,-84
1,0,5,0,3,55,9,-46
2,0,1,0,3,19,9,-10
1,0,6,0,3,90,98,8
1,0,6,2,3,42,28,-14
2,0,2,1,5,13,236,223
3,0,3,1,3,52,53,1
3,1,0,1,3,10,93,83
1,0,0,1,3,89,7,-82
1,0,2,1,5,273,35,-238
3,0,1,7,3,14,3,-11
3,0,3,4,3,198,54,-144
3,1,0,7,3,98,62,-36
2,0,1,4,3,113,18,-95
3,0,0,1,3,7,67,60
2,0,2,0,5,75,31,-44
1,0,6,1,3,16,44,28
1,0,0,0,3,54,31,-23
1,0,3,0,3,118,131,13
3,0,2,1,5,46,103,57
1,0,3,1,3,180,112,-68
1,0,1,0,3,42,69,27
1,0,6,0,3,70,142,72
1,0,0,4,3,40,73,33
3,0,2,0,5,82,15,-67
2,0,2,4,5,237,52,-185
3,0,3,1,3,56,20,-36
3,1,7,5,3,2,7,5
1,0,5,0,3,28,4,-24
2,0,3,1,3,78,12,-66
3,1,1,0,3,53,64,11
3,1,0,1,3,16,88,72
3,0,6,1,3,110,22,-88
1,0,0,0,3,69,127,58
1,0,0,4,3,29,55,26
3,1,1,4,3,137,63,-74
1,0,0,6,3,71,91,20
1,0,3,1,3,207,134,-73
2,0,0,4,3,42,9,-33
3,0,2,1,5,5,81,76
1,0,3,0,3,49,95,46
3,0,2,1,5,24,63,39
3,1,0,0,3,92,47,-45
3,0,2,2,5,25,105,80
3,1,0,1,3,97,3,-94
3,0,0,1,3,65,61,-4
2,0,3,4,3,38,3,-35
1,0,2,1,5,146,29,-117
3,0,6,2,3,9,29,20
1,0,0,0,3,86,69,-17
3,0,6,0,3,59,35,-24
3,0,2,0,5,76,31,-45
0,1,3,1,3,54,80,26
1,0,0,0,3,95,23,-72
1,0,1,0,3,144,209,65
1,0,3,1,3,123,159,36
3,1,3,0,3,71,5,-66
3,0,3,0,3,-1,7,8
3,0,3,4,3,23,155,132
3,0,0,1,3,276,15,-261
3,0,1,7,3,7,11,4
3,0,0,7,3,145,58,-87
1,0,6,2,3,58,86,28
3,1,0,0,3,12,197,185
2,0,2,0,5,78,14,-64
1,0,6,2,3,32,2,-30
3,0,3,0,3,99,526,427
3,0,6,0,3,34,163,129
1,0,0,4,3,18,226,208
2,0,3,6,3,12,78,66
3,0,6,0,3,35,86,51
3,0,2,0,5,73,287,214
3,0,2,0,5,75,93,18
3,0,3,1,3,61,43,-18
3,0,0,4,3,40,185,145
3,0,0,1,3,164,18,-146
3,0,4,2,3,28,85,57
3,0,0,0,3,64,65,1
1,0,2,1,5,13,195,182
1,0,4,1,3,61,20,-41
3,0,6,6,3,66,1,-65
3,0,2,0,5,62,114,52
1,0,4,2,3,36,63,27
3,0,6,2,3,4,16,12
3,1,0,6,3,14,38,24
3,1,6,4,3,21,9,-12
1,0,2,1,5,3,40,37
3,1,4,0,3,69,72,3
3,0,3,6,3,28,31,3
3,0,2,4,5,11,3,-8
1,0,3,1,3,244,36,-208
1,0,0,4,3,295,22,-273
2,0,1,0,3,25,45,20
1,0,3,0,3,43,102,59
3,1,0,4,3,44,17,-27
3,0,2,0,5,58,6,-52
3,0,1,0,3,159,155,-4
3,0,6,0,3,48,88,40
1,0,5,1,3,15,54,39
1,1,0,1,3,69,35,-34
3,0,3,0,3,129,70,-59
3,0,5,6,3,58,1,-57
1,0,0,1,3,120,11,-109
3,0,5,0,3,77,31,-46
3,0,2,1,5,76,6,-70
1,0,5,0,3,97,47,-50
1,1,0,1,3,35,100,65
3,0,3,1,3,52,32,-20
1,0,0,0,3,246,94,-152
3,1,3,7,3,3,20,17
1,0,0,0,3,71,66,-5
1,0,6,2,3,5,40,35
3,0,2,0,5,34,73,39
1,0,2,0,5,166,34,-132
1,0,6,0,3,512,622,110
1,0,3,1,3,108,44,-64
3,0,3,4,3,71,96,25
3,1,5,2,3,14,1,-13
3,0,0,0,3,64,41,-23
3,0,0,1,3,74,5,-69
3,0,0,1,3,901,29,-872
1,0,6,0,3,34,159,125
1,0,6,2,3,11,7,-4
1,0,0,4,3,49,14,-35
3,1,0,0,3,133,119,-14
1,0,0,4,3,137,112,-25
3,0,0,0,3,78,86,8
1,0,6,1,3,48,12,-36
2,0,0,0,3,50,35,-15
3,0,6,0,3,44,40,-4
3,0,0,0,3,99,70,-29
2,0,0,1,3,101,67,-34
2,0,0,0,3,129,546,417
1,1,0,0,3,67,74,7
3,0,6,0,3,241,38,-203
1,0,3,1,3,133,69,-64
3,0,4,6,3,2,9,7
2,0,0,4,3,124,26,-98
2,0,2,4,5,5,90,85
1,0,5,1,3,37,40,3
3,0,3,0,3,187,90,-97
1,0,3,6,3,20,50,30
3,0,2,2,5,32,5,-27
2,0,2,1,5,27,112,85
3,1,3,4,3,27,30,3
1,0,6,6,3,1,4,3
3,1,6,0,3,25,36,11
2,0,2,4,5,92,8,-84
3,0,3,0,3,72,78,6
3,0,3,0,3,96,123,27
3,0,0,4,3,67,28,-39
1,0,5,0,3,48,7,-41
1,0,3,4,3,58,160,102
1,0,0,4,3,48,46,-2
2,0,0,0,3,179,65,-114
3,1,3,1,3,20,261,241
1,0,1,0,3,207,65,-142
3,0,0,0,3,34,83,49
3,0,4,0,3,105,124,19
3,0,5,0,3,7,61,54
3,1,0,0,3,57,69,12
1,0,0,1,3,88,45,-43
3,0,3,0,3,278,3,-275
3,1,0,1,3,43,94,51
3,0,0,0,3,512,86,-426
3,0,2,3,5,19,69,50
3,0,6,0,3,113,71,-42
3,0,2,1,5,79,16,-63
1,0,2,2,5,79,41,-38
2,0,2,0,5,35,192,157
3,0,6,0,3,43,24,-19
1,0,2,0,5,438,121,-317
1,0,1,0,3,74,37,-37
3,0,6,1,3,11,37,26
3,1,3,0,3,86,108,22
1,0,1,6,3,63,13,-50
0,1,3,1,3,49,19,-30
1,0,6,0,3,88,13,-75
3,1,0,0,3,189,62,-127
3,0,6,1,3,9,70,61
3,0,1,0,3,68,17,-51
3,1,0,1,3,49,112,63
1,0,6,1,3,2,46,44
3,0,4,2,3,63,35,-28
0,1,5,6,3,3,10,7
1,0,1,1,3,78,15,-63
1,0,0,1,3,96,74,-22
1,0,5,2,3,69,4,-65
3,0,0,0,3,53,81,28
3,0,2,4,5,4,71,67
1,0,3,1,3,211,19,-192
3,0,4,0,3,119,61,-58
1,0,6,2,3,152,40,-112
3,1,4,1,3,33,12,-21
2,0,0,0,3,216,64,-152
3,0,6,1,3,9,121,112
3,0,3,0,3,74,60,-14
3,0,6,1,3,61,24,-37
3,0,3,4,3,3,31,28
2,0,3,0,3,58,66,8
1,0,0,1,3,59,49,-10
3,0,0,2,3,51,52,1
3,0,1,0,3,90,43,-47
1,0,2,2,5,29,6,-23
3,0,0,6,3,34,63,29
1,0,4,7,3,46,32,-14
0,1,3,6,3,9,2,-7
1,0,0,1,3,48,42,-6
3,1,1,1,3,17,67,50
3,1,0,4,3,80,99,19
1,0,0,0,3,46,35,-11
3,1,6,0,3,51,48,-3
3,0,0,1,3,12,88,76
1,0,3,0,3,84,324,240
3,1,0,1,3,71,23,-48
3,0,6,0,3,76,82,6
2,0,2,0,5,210,20,-190
2,0,2,0,5,78,161,83
3,1,0,0,3,74,147,73
3,0,0,1,3,9,46,37
3,0,6,0,3,67,54,-13
3,1,4,0,3,195,18,-177
1,0,3,0,3,98,284,186
1,0,6,1,3,47,25,-22
1,0,1,1,3,186,37,-149
1,0,0,0,3,98,350,252
3,0,4,0,3,134,53,-81
3,0,0,4,3,47,35,-12
1,0,3,0,3,93,79,-14
2,0,2,0,5,14,215,201
3,0,1,1,3,11,63,52
3,1,1,0,3,58,19,-39
3,0,6,3,3,6,10,4
1,0,2,2,5,77,92,15
3,1,3,6,3,20,103,83
3,1,6,0,3,54,17,-37
3,0,2,0,5,29,58,29
0,1,5,0,3,36,34,-2
3,0,4,2,3,86,115,29
1,0,0,0,3,59,36,-23
1,0,2,1,5,9,141,132
3,1,1,0,3,36,38,2
1,0,2,2,5,81,34,-47
3,1,0,0,3,466,27,-439
3,0,0,0,3,10,96,86
3,1,0,0,3,119,122,3
1,0,0,0,3,71,80,9
3,1,1,1,3,59,4,-55
1,0,3,4,3,37,24,-13
3,0,5,1,3,132,26,-106
3,1,1,0,3,83,145,62
3,1,6,0,3,24,52,28
1,0,0,1,3,9,96,87
3,0,6,0,3,31,111,80
1,0,0,0,3,45,47,2
2,0,2,0,5,12,89,77
3,0,6,0,3,219,46,-173
3,0,1,0,3,29,101,72
3,0,5,0,3,19,150,131
2,0,0,1,3,21,49,28
2,0,0,0,3,319,36,-283
0,1,3,7,3,27,6,-21
3,0,0,6,3,12,48,36
3,0,6,3,3,31,20,-11
1,0,1,6,3,1,8,7
0,1,3,0,3,47,27,-20
3,0,0,0,3,160,302,142
1,0,0,1,3,21,69,48
3,1,0,4,3,90,38,-52
2,0,2,0,5,14,70,56
1,0,4,0,3,280,1249,969
3,0,4,0,3,40,26,-14
1,0,1,2,3,27,11,-16
3,0,2,1,5,104,30,-74
3,0,6,1,3,91,33,-58
1,0,6,0,3,15,35,20
3,0,1,0,3,425,25,-400
3,0,0,0,3,65,130,65
3,0,1,1,3,11,17,6
3,0,2,0,5,102,1,-101
1,0,0,0,3,42,135,93
3,0,6,1,3,16,144,128
3,1,3,1,3,362,50,-312
3,0,3,0,3,196,193,-3
1,0,2,0,5,52,70,18
1,0,1,0,3,60,50,-10
3,0,6,1,3,51,32,-19
3,0,1,0,3,14,27,13
3,0,6,6,3,12,1,-11
1,0,5,0,3,46,50,4
1,0,2,1,5,209,36,-173
3,0,3,1,3,64,77,13
1,0,2,0,5,96,87,-9
3,0,0,6,3,34,30,-4
1,0,2,0,5,8,69,61
3,0,2,0,5,14,120,106
0,1,3,7,3,38,37,-1
1,0,0,0,3,97,104,7
1,0,6,2,3,16,22,6
1,0,0,0,3,67,71,4
3,0,1,0,3,125,35,-90
2,0,0,6,3,42,31,-11
1,0,3,4,3,214,56,-158
3,0,0,4,3,36,42,6
3,1,6,2,3,24,19,-5
1,0,6,1,3,19,32,13
3,1,0,1,3,47,88,41
3,1,0,4,3,32,13,-19
1,0,5,0,3,48,18,-30
3,0,5,1,3,64,15,-49
1,0,3,1,3,494,20,-474
1,0,0,0,3,352,57,-295
3,0,0,1,3,78,71,-7
3,0,0,1,3,84,6,-78
1,0,0,1,3,5,65,60
3,0,2,0,5,63,80,17
3,1,0,1,3,84,170,86
3,0,0,1,3,55,784,729
3,0,3,0,3,86,15,-71
1,0,0,6,3,57,94,37
3,0,5,0,3,68,43,-25
3,0,3,0,3,51,48,-3
3,0,0,4,3,85,13,-72
3,0,5,0,3,36,16,-20
1,0,5,2,3,10,7,-3
3,0,1,4,3,45,200,155
3,0,3,0,3,153,414,261
3,0,5,4,3,9,14,5
3,1,3,4,3,220,33,-187
1,0,1,6,3,10,26,16
2,0,2,2,5,37,89,52
3,0,1,0,3,34,19,-15
1,0,3,1,3,36,103,67
3,1,6,1,3,61,19,-42
1,1,0,0,3,61,108,47
3,1,0,6,3,11,27,16
3,1,0,1,3,140,181,41
3,0,2,0,5,153,56,-97
1,0,0,0,3,212,155,-57
3,0,5,2,3,17,8,-9
3,0,6,1,3,52,32,-20
3,0,2,0,5,140,186,46
1,0,6,2,3,34,6,-28
3,0,4,2,3,25,14,-11
3,1,4,6,3,6,97,91
1,0,0,1,3,172,18,-154
1,0,0,0,3,74,426,352
1,0,1,0,3,76,98,22
1,0,5,7,3,2,1,-1
1,0,6,0,3,31,36,5
1,0,5,1,3,101,4,-97
2,0,0,0,3,53,78,25
0,1,5,4,3,20,63,43
3,1,0,1,3,148,10,-138
1,0,2,0,5,26,102,76
3,0,3,1,3,193,15,-178
1,0,3,4,3,78,54,-24
3,0,2,2,5,86,31,-55
3,0,0,0,3,25,15,-10
3,0,2,0,5,54,81,27
1,0,6,6,3,2,20,18
3,0,1,0,3,89,17,-72
3,1,1,1,3,7,35,28
1,0,3,1,3,89,42,-47
3,0,2,0,5,68,81,13
1,0,6,0,3,21,30,9
1,0,0,0,3,89,60,-29
3,0,2,0,5,108,223,115
2,0,2,0,5,62,83,21
2,0,2,2,5,18,64,46
1,0,3,0,3,33,100,67
2,0,3,0,3,30,94,64
3,1,0,6,3,85,26,-59
3,0,3,0,3,87,217,130
1,0,4,0,3,109,162,53
3,0,4,0,3,16,46,30
3,1,1,4,3,56,7,-49
3,1,6,2,3,11,6,-5
3,0,2,0,5,100,210,110
3,0,6,2,3,28,15,-13
1,0,0,4,3,25,67,42
3,0,2,0,5,188,31,-157
3,0,1,0,3,35,7,-28
3,0,2,0,5,66,20,-46
3,0,3,1,3,6,51,45
3,0,5,0,3,89,72,-17
1,0,5,2,3,12,51,39
1,0,6,1,3,3,33,30
1,0,0,0,3,181,74,-107
1,0,0,0,3,60,38,-22
1,0,0,0,3,64,81,17
1,0,0,0,3,326,151,-175
3,0,6,2,3,4,68,64
3,1,3,0,3,58,53,-5
3,0,3,0,3,75,395,320
2,0,0,0,3,83,122,39
3,1,3,0,3,152,113,-39
3,0,7,6,3,1,3,2
1,0,0,0,3,129,119,-10
3,0,0,2,3,50,28,-22
1,0,3,4,3,47,31,-16
3,1,7,5,3,9,7,-2
1,0,2,1,5,190,72,-118
1,0,3,4,3,109,65,-44
3,0,5,0,3,1,24,23
3,0,1,4,3,13,50,37
3,0,0,4,3,37,6,-31
1,1,0,1,3,92,93,1
2,0,0,0,3,114,122,8
1,0,0,1,3,43,93,50
1,0,6,2,3,8,10,2
3,0,0,2,3,52,22,-30
1,0,4,0,3,28,48,20
1,0,3,1,3,239,26,-213
3,0,2,0,5,728,75,-653
2,0,0,0,3,151,11,-140
3,0,0,1,3,146,155,9
3,0,3,7,3,7,6,-1
3,0,0,1,3,157,39,-118
1,0,0,0,3,42,59,17
3,1,0,0,3,58,156,98
3,1,0,4,3,12,29,17
2,0,0,1,3,19,83,64
3,0,6,1,3,43,26,-17
1,0,3,0,3,237,171,-66
3,0,2,1,5,42,16,-26
3,1,1,6,3,24,7,-17
3,0,2,0,5,22,93,71
3,0,6,0,3,24,29,5
0,1,3,0,3,94,38,-56
3,0,1,1,3,65,26,-39
3,0,1,0,3,65,44,-21
3,0,2,4,5,57,4,-53
2,0,2,0,5,137,68,-69
3,0,3,0,3,46,138,92
1,0,3,0,3,129,79,-50
1,0,3,7,3,13,14,1
2,0,0,4,3,34,2,-32
3,0,3,1,3,115,37,-78
1,0,6,0,3,93,26,-67
3,0,0,4,3,15,47,32
1,0,3,6,3,83,2,-81
3,0,6,1,3,4,44,40
1,0,0,0,3,67,53,-14
1,0,0,0,3,77,23,-54
3,0,1,0,3,210,50,-160
3,1,0,1,3,9,204,195
1,0,6,1,3,38,13,-25
1,0,3,1,3,164,75,-89
3,1,6,1,3,180,63,-117
0,1,3,0,3,26,163,137
3,0,6,2,3,7,11,4
0,1,3,0,3,66,11,-55
3,0,0,0,3,53,116,63
3,1,7,6,3,7,1,-6
1,0,3,4,3,102,32,-70
3,1,1,6,3,10,7,-3
3,0,2,0,5,19,62,43
3,0,4,1,3,71,35,-36
2,0,2,0,5,108,96,-12
1,0,4,0,3,81,111,30
1,0,3,0,3,160,42,-118
3,0,4,1,3,8,34,26
1,0,1,7,3,12,39,27
1,0,3,1,3,35,111,76
3,0,1,0,3,120,9,-111
2,0,2,0,5,32,17,-15
3,1,0,0,3,31,68,37
1,0,0,6,3,38,6,-32
3,0,2,1,5,28,53,25
3,0,2,0,5,4,33,29
3,1,0,0,3,79,125,46
1,0,3,0,3,91,70,-21
1,0,2,1,5,155,107,-48
1,0,0,0,3,56,54,-2
1,0,3,0,3,55,112,57
3,0,2,1,5,73,100,27
1,0,4,0,3,86,95,9
3,0,0,1,3,521,9,-512
1,0,3,0,3,138,109,-29
3,0,2,0,5,96,32,-64
3,0,1,0,3,68,155,87
1,0,0,0,3,117,58,-59
1,0,2,0,5,1,58,57
3,0,5,0,3,29,74,45
1,0,5,2,3,29,41,12
3,1,0,0,3,126,36,-90
2,0,0,0,3,72,104,32
3,1,0,6,3,10,86,76
1,0,6,0,3,48,49,1
3,0,0,1,3,40,72,32
2,0,0,0,3,97,110,13
3,0,1,0,3,41,69,28
1,0,1,0,3,51,36,-15
1,0,3,1,3,425,316,-109
3,0,0,1,3,42,84,42
2,0,0,1,3,35,59,24
2,0,1,6,3,22,33,11
3,0,5,0,3,41,19,-22
3,0,3,4,3,11,21,10
3,1,3,0,3,71,55,-16
1,0,3,4,3,61,196,135
3,1,7,5,3,7,5,-2
3,0,0,1,3,23,191,168
1,0,1,1,3,6,106,100
3,0,2,3,5,39,14,-25
3,0,2,0,5,186,19,-167
1,0,0,6,3,48,46,-2
3,0,2,0,5,98,41,-57
1,0,2,0,5,132,66,-66
1,0,2,0,5,46,103,57
2,0,2,0,5,54,110,56
1,0,0,0,3,160,37,-123
3,0,2,1,5,53,58,5
3,0,2,0,5,95,6,-89
3,0,2,1,5,25,63,38
3,0,6,0,3,77,58,-19
2,0,0,2,3,17,30,13
1,0,2,1,5,164,2,-162
3,0,4,0,3,93,103,10
3,1,3,1,3,35,152,117
3,1,1,7,3,5,21,16
3,0,5,2,3,42,38,-4
3,1,0,7,3,8,70,62
3,0,6,0,3,55,42,-13
1,0,6,1,3,41,9,-32
3,0,6,0,3,144,45,-99
2,0,3,1,3,116,276,160
3,0,6,4,3,8,276,268
1,0,3,1,3,86,37,-49
0,1,5,0,3,60,41,-19
3,0,4,4,3,42,32,-10
3,0,2,0,5,61,33,-28
1,0,0,1,3,435,46,-389
3,1,0,0,3,79,43,-36
1,0,5,2,3,19,6,-13
3,0,6,3,3,17,60,43
2,0,2,1,5,59,48,-11
3,0,1,1,3,163,59,-104
3,1,0,1,3,7,76,69
3,0,2,0,5,9,78,69
1,0,2,2,5,15,26,11
1,0,1,0,3,81,150,69
3,1,5,0,3,57,130,73
1,0,0,1,3,21,105,84
1,0,2,1,5,46,10,-36
2,0,0,0,3,265,72,-193
3,0,2,0,5,110,68,-42
2,0,2,0,5,12,23,11
2,0,2,1,5,22,58,36
3,0,0,0,3,66,43,-23
1,0,5,0,3,17,19,2
3,1,3,0,3,20,272,252
3,1,4,7,3,72,46,-26
3,0,6,4,3,13,20,7
1,0,0,0,3,66,765,699
2,0,2,1,5,40,6,-34
3,1,0,1,3,10,260,250
3,1,4,1,3,95,3,-92
3,0,2,0,5,141,209,68
2,0,3,1,3,43,97,54
3,0,6,4,3,38,39,1
2,0,1,1,3,24,41,17
2,0,1,4,3,23,51,28
3,0,1,0,3,155,149,-6
3,0,1,1,3,143,45,-98
3,1,6,0,3,37,25,-12
1,0,3,0,3,60,495,435
1,0,2,0,5,242,57,-185
3,0,0,1,3,44,12,-32
3,0,6,0,3,166,141,-25
1,0,6,2,3,1,40,39
1,0,2,1,5,89,24,-65
3,0,3,6,3,79,30,-49
1,0,2,0,5,264,111,-153
1,0,5,0,3,41,54,13
3,0,1,4,3,17,6,-11
2,0,2,1,5,195,7,-188
3,1,3,4,3,84,3,-81
1,0,2,0,5,79,19,-60
2,0,2,1,5,84,72,-12
3,0,0,0,3,94,99,5
3,1,0,1,3,48,17,-31
1,0,1,0,3,37,54,17
3,0,0,0,3,57,47,-10
0,1,3,0,3,29,108,79
3,0,2,1,5,161,7,-154
1,1,0,1,3,61,30,-31
2,0,2,2,5,70,10,-60
3,0,5,0,3,63,46,-17
3,0,6,1,3,29,58,29
1,0,1,1,3,26,42,16
1,0,6,1,3,18,77,59
3,1,0,4,3,49,13,-36
1,0,0,1,3,16,100,84
0,1,3,1,3,49,1,-48
1,0,5,0,3,59,8,-51
3,1,0,6,3,25,12,-13
3,0,6,4,3,1,6,5
2,0,2,0,5,1065,27,-1038
3,1,0,1,3,28,132,104
3,0,2,2,5,33,6,-27
3,1,0,1,3,70,54,-16
1,0,2,2,5,10,75,65
1,0,2,1,5,49,19,-30
3,1,1,7,3,1,4,3
1,0,1,1,3,9,94,85
3,0,0,1,3,38,157,119
3,0,2,1,5,12,43,31
1,0,0,0,3,613,394,-219
3,0,2,0,5,14,37,23
3,0,6,1,3,57,19,-38
1,0,1,0,3,29,50,21
1,0,3,6,3,60,51,-9
3,0,0,0,3,369,495,126
3,0,0,0,3,51,107,56
3,0,0,4,3,46,85,39
3,0,3,1,3,99,49,-50
3,0,2,0,5,183,56,-127
3,0,0,4,3,82,63,-19
1,0,5,0,3,31,553,522
0,1,3,1,3,37,192,155
3,1,4,1,3,7,52,45
2,0,0,2,3,65,2,-63
3,0,6,0,3,248,65,-183
3,1,6,1,3,41,5,-36
3,0,1,0,3,63,53,-10
3,0,3,0,3,66,93,27
3,0,6,1,3,39,33,-6
3,1,1,1,3,35,68,33
2,0,2,0,5,50,1,-49
1,0,0,4,3,25,94,69
3,0,2,0,5,98,22,-76
2,0,0,0,3,46,95,49
1,0,3,4,3,103,352,249
1,1,0,0,3,114,81,-33
1,0,0,6,3,168,5,-163
3,1,6,1,3,55,1,-54
3,0,6,0,3,94,69,-25
3,0,6,4,3,26,3,-23
3,1,1,4,3,67,25,-42
3,0,3,0,3,124,123,-1
1,0,0,1,3,62,106,44
1,0,6,6,3,2,12,10
3,0,0,0,3,81,63,-18
3,0,5,1,3,4,35,31
3,1,4,4,3,90,12,-78
3,1,4,0,3,89,78,-11
1,0,1,0,3,349,47,-302
3,1,1,0,3,317,28,-289
3,1,0,1,3,121,156,35
3,1,6,1,3,11,35,24
1,0,0,0,3,313,205,-108
3,1,0,1,3,42,7,-35
3,0,6,0,3,10,33,23
3,1,3,1,3,79,122,43
2,0,0,0,3,59,41,-18
3,0,0,1,3,30,88,58
3,0,2,0,5,13,89,76
1,0,4,0,3,192,113,-79
3,0,1,0,3,86,69,-17
3,0,1,0,3,52,6,-46
3,0,3,0,3,293,138,-155
3,0,3,1,3,55,17,-38
2,0,2,1,5,9,59,50
3,0,3,1,3,1121,35,-1086
2,0,0,1,3,40,197,157
3,0,0,4,3,34,13,-21
2,0,0,0,3,93,54,-39
1,0,0,1,3,47,50,3
1,0,2,0,5,7,71,64
3,0,6,0,3,52,298,246
3,0,3,1,3,114,127,13
1,0,3,0,3,91,80,-11
1,0,3,1,3,113,34,-79
1,0,2,1,5,29,112,83
3,0,2,6,5,3,2,-1
3,0,1,0,3,9,70,61
1,0,2,1,5,145,15,-130
1,0,0,1,3,97,103,6
3,1,0,0,3,32,93,61
3,0,2,0,5,129,70,-59
0,1,3,4,3,141,36,-105
3,0,2,0,5,51,21,-30
3,0,0,1,3,99,373,274
3,0,2,1,5,2,44,42
3,0,3,0,3,30,59,29
3,0,2,0,5,5,76,71
1,0,2,1,5,130,12,-118
1,0,3,0,3,104,134,30
1,0,3,1,3,3,96,93
3,0,5,1,3,7,121,114
3,0,0,4,3,80,6,-74
3,1,3,7,3,2,1,-1
1,0,0,6,3,28,41,13
1,0,0,0,3,127,47,-80
0,1,3,4,3,40,4,-36
3,0,6,1,3,84,19,-65
3,0,0,1,3,12,74,62
1,0,0,0,3,91,46,-45
3,0,0,4,3,64,138,74
1,0,2,0,5,118,15,-103
3,0,0,0,3,94,53,-41
3,0,1,0,3,52,50,-2
2,0,3,1,3,35,99,64
2,0,0,0,3,75,29,-46
1,0,3,6,3,36,2,-34
3,0,3,4,3,155,21,-134
3,0,3,5,3,99,67,-32
3,0,2,2,5,18,22,4
3,0,2,2,5,46,31,-15
3,0,3,0,3,83,106,23
3,1,0,4,3,9,64,55
1,0,0,1,3,57,28,-29
3,0,2,1,5,78,14,-64
3,0,3,0,3,124,340,216
2,0,2,1,5,74,3,-71
1,0,0,6,3,114,87,-27
1,0,0,4,3,49,246,197
3,0,0,0,3,70,104,34
3,1,0,0,3,35,71,36
1,0,1,2,3,9,27,18
3,0,2,0,5,106,42,-64
3,0,6,0,3,20,131,111
2,0,3,0,3,1343,10,-1333
2,0,0,1,3,34,44,10
1,0,0,4,3,67,68,1
3,1,1,0,3,10,82,72
1,0,0,0,3,187,54,-133
1,0,0,1,3,25,270,245
3,0,2,0,5,84,91,7
1,0,0,0,3,344,271,-73
1,0,0,0,3,70,79,9
3,0,5,0,3,82,96,14
3,0,0,0,3,55,32,-23
3,0,0,4,3,25,74,49
3,1,3,0,3,81,137,56
3,0,0,4,3,67,53,-14
3,0,0,0,3,105,32,-73
3,0,2,0,5,55,132,77
3,0,3,0,3,144,5,-139
1,0,6,1,3,24,6,-18
3,0,3,0,3,74,27,-47
1,0,0,4,3,93,105,12
1,0,0,0,3,73,168,95
3,1,3,0,3,86,68,-18
3,0,0,0,3,48,194,146
2,0,3,0,3,83,-1,-84
3,0,2,3,5,23,1,-22
1,0,1,1,3,5,63,58
3,1,0,4,3,128,25,-103
1,0,0,6,3,64,45,-19
3,0,3,0,3,111,139,28
3,0,4,6,3,31,121,90
1,0,6,4,3,5,35,30
1,0,2,1,5,7,77,70
2,0,2,2,5,116,11,-105
3,0,3,4,3,61,164,103
3,1,0,0,3,58,51,-7
3,0,1,0,3,45,16,-29
1,0,4,1,3,17,140,123
3,0,6,1,3,14,50,36
2,0,1,0,3,86,50,-36
1,0,5,4,3,16,6,-10
1,0,6,0,3,38,44,6
1,0,3,0,3,613,66,-547
3,1,3,7,3,9,18,9
0,1,3,0,3,56,95,39
3,0,0,0,3,96,43,-53
3,1,3,0,3,66,57,-9
3,0,6,1,3,66,10,-56
3,0,4,0,3,132,86,-46
0,1,3,4,3,30,5,-25
1,0,3,0,3,105,290,185
1,0,0,1,3,21,45,24
1,0,0,0,3,88,57,-31
1,0,1,4,3,86,2,-84
3,0,3,1,3,21,145,124
1,0,0,4,3,65,92,27
3,0,0,0,3,95,85,-10
1,0,1,1,3,33,78,45
2,0,0,0,3,339,67,-272
3,0,5,0,3,15,35,20
1,0,3,0,3,50,57,7
1,0,0,1,3,76,450,374
3,1,0,4,3,46,33,-13
2,0,3,4,3,24,67,43
1,0,1,1,3,12,78,66
1,0,0,0,3,210,232,22
3,0,0,0,3,57,115,58
3,1,1,0,3,61,16,-45
3,0,5,0,3,14,31,17
3,0,0,1,3,45,121,76
3,0,6,0,3,43,73,30
3,0,2,0,5,137,45,-92
3,0,1,1,3,432,30,-402
3,1,1,6,3,32,18,-14
2,0,2,0,5,29,108,79
3,0,3,1,3,18,114,96
1,0,0,1,3,61,70,9
3,0,6,1,3,35,16,-19
3,0,3,0,3,139,96,-43
1,0,6,1,3,34,11,-23
3,0,1,0,3,120,205,85
3,1,4,0,3,31,56,25
2,0,2,0,5,102,83,-19
3,0,3,5,3,64,83,19
1,0,3,4,3,51,133,82
3,0,1,1,3,139,32,-107
1,1,0,0,3,63,38,-25
3,0,3,0,3,86,102,16
1,0,1,4,3,28,5,-23
1,0,5,0,3,70,125,55
1,0,3,1,3,164,254,90
1,0,0,6,3,61,60,-1
1,0,5,1,3,24,18,-6
2,0,0,4,3,9,502,493
1,0,2,3,5,14,46,32
3,0,6,1,3,31,98,67
1,0,0,4,3,67,35,-32
3,0,6,1,3,44,95,51
3,0,0,0,3,125,324,199
3,1,6,1,3,14,105,91
2,0,0,1,3,144,161,17
1,0,0,4,3,14,2520,2506
1,0,2,0,5,61,17,-44
3,0,0,6,3,62,13,-49
3,0,3,0,3,31,117,86
1,0,0,1,3,50,95,45
3,0,6,0,3,46,48,2
1,0,0,0,3,101,153,52
1,0,0,4,3,5,51,46
1,0,2,4,5,10,37,27
3,0,3,4,3,92,409,317
0,1,5,0,3,33,44,11
3,1,1,4,3,37,48,11
3,1,0,0,3,182,85,-97
3,0,0,7,3,42,35,-7
3,1,0,1,3,334,30,-304
1,0,0,4,3,8,71,63
1,0,0,1,3,111,23,-88
3,0,2,0,5,188,4,-184
2,0,2,3,5,13,4,-9
3,0,0,0,3,98,93,-5
1,1,0,0,3,103,227,124
3,0,0,1,3,52,3,-49
3,0,1,0,3,808,67,-741
3,1,4,1,3,19,58,39
3,0,3,1,3,141,13,-128
2,0,3,1,3,121,361,240
1,0,5,0,3,93,57,-36
0,1,3,0,3,165,38,-127
3,1,6,1,3,36,13,-23
1,0,3,1,3,24,93,69
3,1,5,4,3,18,10,-8
1,0,1,0,3,190,60,-130
3,0,3,0,3,92,201,109
1,0,6,0,3,13,55,42
3,0,4,1,3,109,65,-44
3,0,6,0,3,21,22,1
0,1,3,1,3,105,44,-61
3,0,2,0,5,33,32,-1
3,0,0,2,3,31,35,4
3,1,3,1,3,308,164,-144
1,0,5,1,3,46,48,2
1,0,0,1,3,208,119,-89
3,0,3,1,3,73,33,-40
3,0,6,7,3,7,17,10
3,0,0,4,3,60,266,206
3,0,6,1,3,17,69,52
3,0,6,7,3,4,1,-3
1,0,0,0,3,42,38,-4
3,0,2,4,5,8,1,-7
1,0,0,0,3,114,384,270
3,0,6,7,3,4,20,16
1,0,0,1,3,99,168,69
3,0,2,1,5,22,34,12
2,0,1,0,3,83,2,-81
1,0,4,2,3,27,7,-20
1,0,2,1,5,39,78,39
3,1,1,1,3,41,3,-38
3,0,5,0,3,15,27,12
3,0,2,1,5,87,9,-78
1,0,6,0,3,42,10,-32
3,1,1,0,3,78,69,-9
1,0,2,0,5,137,117,-20
3,0,6,0,3,612,51,-561
3,0,2,0,5,83,61,-22
3,1,3,4,3,56,48,-8
3,0,5,1,3,33,38,5
3,0,2,0,5,6,41,35
1,0,6,1,3,54,7,-47
1,0,6,0,3,81,78,-3
3,0,0,0,3,91,88,-3
3,0,6,0,3,331,52,-279
3,0,2,4,5,1,15,14
1,0,3,6,3,156,9,-147
2,0,3,0,3,71,35,-36
3,1,3,0,3,56,13,-43
3,0,3,0,3,11,21,10
2,0,0,0,3,41,26,-15
3,1,0,0,3,133,134,1
1,0,0,0,3,32,55,23
1,0,0,4,3,8,65,57
3,0,6,0,3,85,40,-45
1,0,0,7,3,40,57,17
3,1,0,0,3,6,76,70
3,0,3,0,3,231,29,-202
3,0,6,1,3,36,84,48
1,0,0,1,3,564,46,-518
1,0,3,6,3,7,5,-2
1,0,6,0,3,15,33,18
3,0,3,6,3,42,15,-27
3,0,6,1,3,6,131,125
2,0,0,4,3,394,361,-33
3,0,6,0,3,21,29,8
3,0,0,4,3,13,1,-12
1,0,3,0,3,182,3,-179
3,0,3,7,3,158,3,-155
3,0,6,0,3,27,28,1
3,1,0,1,3,55,165,110
1,0,5,6,3,6,53,47
3,0,6,0,3,73,86,13
3,0,5,0,3,105,330,225
1,0,3,0,3,130,38,-92
3,0,3,1,3,97,78,-19
3,0,2,1,5,114,24,-90
2,0,2,6,5,2,1,-1
1,0,1,0,3,58,31,-27
2,0,2,1,5,93,135,42
2,0,2,0,5,53,74,21
3,0,0,0,3,898,40,-858
1,0,5,0,3,23,1,-22
2,0,1,0,3,53,6,-47
1,0,6,0,3,52,44,-8
3,1,1,1,3,21,7,-14
3,0,0,0,3,139,114,-25
3,0,2,2,5,12,40,28
1,0,5,2,3,8,52,44
3,0,0,0,3,57,32,-25
3,0,6,0,3,60,16,-44
1,0,2,2,5,13,62,49
0,1,3,0,3,32,72,40
2,0,2,0,5,5,35,30
3,0,0,0,3,84,85,1
1,0,5,1,3,123,17,-106
3,0,5,2,3,14,25,11
3,0,6,0,3,1022,54,-968
1,0,2,0,5,64,84,20
1,0,3,7,3,15,65,50
2,0,0,1,3,67,32,-35
3,1,0,4,3,10,33,23
1,0,3,1,3,230,45,-185
3,0,3,1,3,29,285,256
1,0,0,1,3,85,20,-65
1,0,3,0,3,59,432,373
1,0,2,2,5,95,4,-91
3,0,5,0,3,24,33,9
1,0,0,1,3,34,102,68
3,0,0,0,3,38,103,65
3,0,6,1,3,39,24,-15
3,0,4,6,3,11,7,-4
3,1,3,1,3,19,138,119
3,0,1,7,3,3,72,69
1,0,0,0,3,86,87,1
3,1,1,1,3,58,31,-27
1,0,5,0,3,46,61,15
1,0,2,0,5,162,15,-147
3,0,1,1,3,90,6,-84
3,0,6,6,3,5,28,23
3,0,5,0,3,38,34,-4
3,0,5,6,3,8,50,42
1,0,0,0,3,74,55,-19
3,0,1,4,3,9,2,-7
2,0,3,0,3,64,30,-34
3,0,0,2,3,27,32,5
3,0,1,0,3,63,72,9
1,0,3,0,3,39,485,446
2,0,0,0,3,46,136,90
1,0,0,7,3,47,335,288
3,0,0,0,3,64,58,-6
1,0,3,0,3,121,29,-92
3,0,2,2,5,74,18,-56
1,0,1,1,3,57,39,-18
1,0,0,0,3,89,76,-13
3,0,3,1,3,145,14,-131
2,0,2,1,5,47,3,-44
1,0,3,1,3,103,94,-9
3,1,3,4,3,3,34,31
3,1,1,1,3,67,75,8
2,0,2,0,5,2,122,120
1,0,2,0,5,136,14,-122
2,0,2,0,5,80,73,-7
3,0,2,1,5,25,67,42
3,1,0,0,3,92,223,131
3,0,3,1,3,39,173,134
0,1,3,0,3,20,34,14
1,0,0,0,3,116,108,-8
1,0,2,2,5,29,2,-27
3,0,0,0,3,216,40,-176
3,1,6,0,3,42,16,-26
1,0,0,0,3,104,671,567
3,1,0,1,3,153,150,-3
3,1,0,4,3,23,73,50
2,0,2,0,5,33,491,458
3,0,2,0,5,301,87,-214
2,0,2,2,5,9,18,9
1,0,5,4,3,59,16,-43
1,0,0,0,3,226,104,-122
1,0,3,1,3,175,126,-49
1,1,0,0,3,97,105,8
1,0,3,4,3,13,226,213
2,0,0,0,3,301,57,-244
1,0,2,0,5,94,84,-10
0,1,5,1,3,13,74,61
3,0,6,3,3,119,62,-57
1,0,2,3,5,38,7,-31
3,0,3,0,3,75,48,-27
3,1,5,4,3,40,10,-30
3,0,5,0,3,61,101,40
3,0,2,0,5,9,38,29
1,0,2,0,5,8,119,111
3,0,6,0,3,27,19,-8
3,0,5,0,3,58,83,25
1,0,5,0,3,80,2,-78
3,0,0,7,3,20,135,115
3,0,2,1,5,78,5,-73
3,1,5,1,3,9,27,18
1,0,0,4,3,208,105,-103
3,1,0,0,3,50,62,12
3,1,0,0,3,48,45,-3
3,1,3,0,3,130,44,-86
3,0,5,6,3,2,3,1
3,0,5,2,3,15,2,-13
3,0,1,0,3,48,51,3
1,0,0,4,3,28,31,3
3,1,0,1,3,37,60,23
1,0,2,0,5,79,40,-39
3,1,3,0,3,2,119,117
1,0,4,0,3,23,53,30
3,0,1,6,3,50,215,165
3,0,0,1,3,42,20,-22
3,1,0,4,3,388,50,-338
3,1,5,6,3,9,50,41
1,0,0,4,3,6,88,82
3,1,0,1,3,101,2,-99
1,0,0,0,3,89,100,11
1,0,5,2,3,8,28,20
3,0,3,1,3,162,70,-92
3,1,1,0,3,36,52,16
1,0,0,1,3,54,78,24
1,0,6,2,3,35,16,-19
3,1,4,4,3,8,23,15
3,0,2,3,5,12,22,10
3,0,5,2,3,60,8,-52
1,0,4,0,3,87,41,-46
3,1,0,0,3,60,75,15
1,0,0,0,3,57,524,467
2,0,0,6,3,52,4,-48
2,0,3,6,3,140,83,-57
3,0,0,1,3,87,21,-66
1,0,0,4,3,102,20,-82
3,0,2,1,5,21,137,116
1,0,1,0,3,35,915,880
1,0,3,0,3,72,97,25
1,0,0,1,3,58,51,-7
3,1,1,1,3,116,11,-105
3,0,2,1,5,183,28,-155
1,0,0,6,3,19,101,82
2,0,3,2,3,2,30,28
3,0,6,3,3,72,13,-59
1,0,6,1,3,46,9,-37
3,0,0,0,3,26,48,22
3,0,6,0,3,121,50,-71
3,0,0,0,3,35,131,96
1,0,0,0,3,35,44,9
3,0,0,1,3,50,116,66
3,0,3,0,3,110,88,-22
3,0,5,1,3,4,82,78
1,0,0,0,3,159,105,-54
1,0,5,0,3,45,34,-11
1,0,1,4,3,51,8,-43
2,0,2,7,5,48,5,-43
3,1,0,0,3,57,137,80
3,0,6,0,3,107,73,-34
3,0,3,0,3,272,59,-213
3,0,5,1,3,43,5,-38
3,1,5,0,3,24,110,86
3,1,0,1,3,102,18,-84
3,1,0,0,3,123,89,-34
1,0,0,7,3,2,23,21
0,1,3,1,3,37,58,21
1,0,6,0,3,73,51,-22
2,0,0,1,3,78,21,-57
3,1,6,1,3,17,103,86
3,0,1,1,3,39,4,-35
3,1,0,4,3,25,53,28
1,0,1,7,3,2,6,4
1,0,0,4,3,58,87,29
1,0,3,1,3,127,121,-6
1,0,0,0,3,49,191,142
3,0,5,0,3,39,41,2
3,0,4,2,3,8,57,49
3,0,0,0,3,40,138,98
2,0,3,2,3,97,60,-37
3,0,0,0,3,28,70,42
3,0,6,1,3,66,4,-62
1,1,0,0,3,273,166,-107
3,0,2,1,5,39,17,-22
1,0,0,6,3,43,57,14
1,0,1,0,3,124,85,-39
1,0,0,0,3,35,56,21
0,1,3,1,3,38,40,2
3,0,0,6,3,6,1,-5
1,0,2,2,5,60,8,-52
1,0,2,0,5,644,105,-539
3,0,3,0,3,124,92,-32
3,1,3,6,3,7,16,9
3,1,3,0,3,73,92,19
1,0,4,0,3,135,153,18
3,1,1,0,3,36,7,-29
3,0,3,0,3,178,139,-39
2,0,3,1,3,53,13,-40
3,0,3,0,3,78,90,12
2,0,2,1,5,64,38,-26
3,1,3,1,3,621,5,-616
3,0,2,0,5,121,37,-84
3,0,0,0,3,94,497,403
1,0,5,1,3,23,2,-21
1,0,4,2,3,62,236,174
1,0,1,0,3,146,57,-89
3,0,2,0,5,85,199,114
3,1,0,7,3,47,16,-31
3,0,2,3,5,9,128,119
3,0,6,1,3,9,44,35
2,0,0,1,3,95,124,29
3,1,0,0,3,79,93,14
3,0,4,1,3,41,10,-31
3,0,6,2,3,7,31,24
3,0,2,0,5,27,102,75
2,0,2,1,5,285,23,-262
1,0,3,0,3,332,39,-293
3,0,1,0,3,82,88,6
1,0,2,2,5,23,97,74
1,0,0,1,3,955,44,-911
1,0,5,0,3,9,211,202
3,0,0,6,3,19,109,90
1,0,3,1,3,234,73,-161
0,1,0,4,3,22,255,233
1,0,2,0,5,39,54,15
3,0,6,1,3,58,24,-34
3,0,0,6,3,14,73,59
1,0,0,0,3,100,43,-57
3,0,1,0,3,11,119,108
3,1,0,0,3,264,61,-203
3,1,3,4,3,74,27,-47
3,0,3,0,3,64,252,188
3,0,0,4,3,78,29,-49
3,0,2,1,5,8,30,22
1,0,0,6,3,44,107,63
3,0,0,0,3,322,86,-236
3,1,0,0,3,28,207,179
3,1,6,0,3,72,31,-41
3,1,0,0,3,70,174,104
1,0,0,4,3,68,23,-45
3,0,1,0,3,42,93,51
1,1,0,6,3,76,27,-49
1,0,6,6,3,24,17,-7
3,0,2,1,5,78,106,28
3,0,5,2,3,2,14,12
3,0,2,0,5,92,23,-69
3,0,3,0,3,54,32,-22
1,0,3,1,3,51,10,-41
3,0,6,0,3,144,48,-96
3,0,2,1,5,65,89,24
3,0,2,0,5,65,139,74
3,0,6,2,3,8,91,83
3,1,0,0,3,52,77,25
1,1,0,0,3,160,52,-108
3,0,1,4,3,5,32,27
1,0,5,0,3,66,113,47
3,0,2,1,5,16,52,36
3,0,6,1,3,38,22,-16
1,0,4,1,3,94,25,-69
3,0,6,1,3,192,2,-190
1,0,3,0,3,9,46,37
1,0,0,1,3,240,15,-225
3,0,5,0,3,64,114,50
3,1,1,1,3,175,57,-118
3,1,0,0,3,59,62,3
3,0,6,0,3,93,60,-33
3,1,4,1,3,57,135,78
3,0,6,1,3,23,92,69
3,0,5,1,3,4,44,40
1,0,1,0,3,44,69,25
1,0,3,6,3,24,55,31
1,0,2,4,5,9,1,-8
1,0,6,2,3,34,6,-28
3,0,3,6,3,19,54,35
3,0,3,4,3,20,126,106
3,0,2,3,5,88,4,-84
3,0,2,0,5,6,186,180
1,0,3,0,3,20,77,57
1,0,0,7,3,111,15,-96
1,0,4,4,3,38,7,-31
1,0,1,0,3,141,82,-59
1,0,0,1,3,337,99,-238
3,0,5,2,3,11,21,10
3,0,6,6,3,1,24,23
1,0,3,4,3,45,12,-33
3,0,2,0,5,75,205,130
3,0,4,0,3,334,243,-91
3,1,5,2,3,92,9,-83
3,1,5,0,3,26,73,47
3,1,1,0,3,117,28,-89
1,0,3,0,3,67,87,20
1,0,0,1,3,212,52,-160
3,0,3,0,3,55,37,-18
3,1,6,0,3,64,45,-19
3,1,6,0,3,56,28,-28
1,0,1,4,3,19,5,-14
3,0,2,0,5,97,108,11
0,1,5,2,3,17,47,30
2,0,2,0,5,54,2,-52
1,0,3,0,3,171,151,-20
3,0,2,1,5,303,66,-237
3,0,6,1,3,100,29,-71
3,1,3,1,3,31,70,39
1,0,4,6,3,41,55,14
3,0,2,0,5,72,231,159
3,0,2,2,5,1,95,94
1,0,2,3,5,14,31,17
3,0,2,0,5,68,25,-43
1,0,6,2,3,33,24,-9
1,0,2,2,5,34,122,88
3,0,6,1,3,71,21,-50
2,0,2,1,5,22,220,198
3,0,0,0,3,36,463,427
0,1,3,0,3,76,170,94
3,0,2,0,5,30,59,29
2,0,3,4,3,214,140,-74
3,1,6,2,3,9,10,1
2,0,2,3,5,20,19,-1
3,0,2,0,5,27,99,72
3,0,6,0,3,23,124,101
3,0,2,0,5,53,101,48
3,1,0,1,3,85,81,-4
2,0,0,0,3,59,47,-12
3,0,0,1,3,58,129,71
1,0,5,0,3,58,11,-47
2,0,3,0,3,129,283,154
3,0,2,2,5,6,33,27
1,0,2,0,5,30,96,66
1,0,0,1,3,61,26,-35
3,0,5,1,3,64,17,-47
1,0,3,0,3,72,41,-31
3,0,0,6,3,107,73,-34
3,0,2,0,5,69,83,14
2,0,2,0,5,547,84,-463
3,0,2,0,5,27,64,37
0,1,3,0,3,79,70,-9
1,0,3,1,3,60,422,362
1,0,3,6,3,120,62,-58
1,0,0,0,3,39,119,80
3,1,0,0,3,168,109,-59
3,0,3,1,3,96,8,-88
3,0,1,1,3,56,42,-14
3,0,1,6,3,19,45,26
1,0,5,0,3,29,14,-15
3,0,5,0,3,68,70,2
3,1,1,0,3,54,44,-10
3,1,0,0,3,68,102,34
3,0,5,2,3,16,20,4
3,0,0,0,3,90,526,436
3,0,2,6,5,16,3,-13
3,0,1,2,3,5,26,21
3,0,2,3,5,11,41,30
3,0,1,1,3,15,153,138
3,0,6,3,3,11,9,-2
3,0,6,0,3,37,36,-1
0,1,3,0,3,25,12,-13
3,0,1,0,3,85,78,-7
1,0,4,1,3,65,243,178
1,0,3,0,3,74,47,-27
1,0,2,0,5,38,46,8
2,0,3,1,3,49,63,14
3,0,2,0,5,105,38,-67
3,1,0,4,3,86,43,-43
1,0,0,0,3,98,49,-49
3,0,3,4,3,42,36,-6
3,0,6,1,3,148,23,-125
3,0,2,0,5,59,32,-27
3,0,0,1,3,95,25,-70
1,0,0,0,3,47,85,38
3,1,0,0,3,30,63,33
1,0,6,0,3,52,21,-31
3,0,1,0,3,54,18,-36
3,0,2,1,5,4,150,146
1,0,0,4,3,55,15,-40
3,0,3,0,3,8,33,25
3,0,6,0,3,85,45,-40
1,0,0,6,3,27,188,161
3,0,3,7,3,35,125,90
1,0,5,0,3,104,46,-58
3,0,4,6,3,35,13,-22
1,0,5,4,3,8,69,61
1,0,4,4,3,14,16,2
1,0,0,0,3,33,63,30
3,1,0,6,3,21,9,-12
3,1,1,1,3,17,35,18
3,0,1,1,3,130,58,-72
3,1,0,6,3,44,72,28
3,1,0,1,3,7,70,63
1,0,2,2,5,35,5,-30
3,1,1,1,3,309,23,-286
3,0,3,1,3,20,144,124
0,1,3,0,3,48,36,-12
3,0,0,1,3,665,50,-615
3,1,3,0,3,36,175,139
1,0,0,0,3,108,59,-49
3,0,6,0,3,53,273,220
2,0,1,0,3,89,22,-67
2,0,1,4,3,1,41,40
3,1,1,1,3,13,37,24
3,0,4,0,3,189,80,-109
3,0,5,0,3,217,79,-138
1,0,1,1,3,89,29,-60
2,0,2,2,5,7,35,28
1,0,2,3,5,41,28,-13
1,0,4,0,3,222,96,-126
3,1,5,6,3,25,3,-22
2,0,3,1,3,55,199,144
3,1,1,4,3,32,113,81
1,0,0,1,3,19,55,36
3,0,0,1,3,11,125,114
2,0,2,1,5,95,42,-53
1,0,3,6,3,15,52,37
1,0,3,4,3,110,254,144
3,0,2,0,5,88,7,-81
3,1,0,6,3,44,35,-9
3,0,0,4,3,18,113,95
3,1,6,0,3,111,34,-77
1,0,0,1,3,87,14,-73
1,0,0,1,3,77,15,-62
3,0,6,0,3,73,111,38
3,0,2,0,5,144,73,-71
1,0,0,0,3,78,220,142
1,0,5,2,3,21,61,40
1,0,0,0,3,37,517,480
1,0,3,1,3,29,116,87
3,0,0,1,3,42,122,80
3,1,0,4,3,18,60,42
3,0,2,1,5,26,111,85
3,0,5,3,3,23,1,-22
3,1,0,1,3,28,60,32
3,1,0,0,3,84,721,637
1,0,6,0,3,11,40,29
3,0,6,4,3,2,11,9
1,0,0,0,3,49,198,149
3,1,0,0,3,79,130,51
3,0,0,0,3,161,64,-97
1,0,0,0,3,69,72,3
3,1,3,4,3,13,42,29
3,1,0,1,3,25,77,52
3,0,2,1,5,9,186,177
3,0,2,2,5,52,64,12
3,1,4,1,3,21,124,103
3,0,6,2,3,65,101,36
3,0,3,0,3,99,24,-75
3,0,3,1,3,143,22,-121
1,0,1,0,3,106,19,-87
3,0,0,1,3,862,93,-769
3,1,0,0,3,165,71,-94
3,0,0,1,3,9,80,71
3,1,0,0,3,149,170,21
3,0,6,0,3,134,81,-53
3,0,2,0,5,58,47,-11
3,0,0,0,3,944,141,-803
3,1,3,0,3,91,76,-15
3,0,4,4,3,96,21,-75
3,0,2,0,5,51,21,-30
3,0,6,6,3,14,34,20
3,0,2,1,5,1,261,260
1,0,0,4,3,47,23,-24
3,0,5,0,3,23,50,27
3,0,6,3,3,7,11,4
1,0,0,0,3,102,40,-62
1,0,2,0,5,79,135,56
3,0,4,0,3,15,43,28
3,1,6,1,3,8,74,66
3,0,2,0,5,19,111,92
3,0,0,0,3,165,37,-128
2,0,0,4,3,71,77,6
2,0,3,1,3,57,169,112
1,0,3,0,3,63,59,-4
1,0,1,0,3,99,119,20
1,1,0,1,3,135,115,-20
3,0,6,2,3,14,9,-5
3,0,5,1,3,8,135,127
3,0,3,4,3,6,25,19
1,0,6,4,3,59,9,-50
1,0,0,1,3,82,60,-22
3,0,5,0,3,8,36,28
3,0,0,2,3,33,47,14
2,0,3,0,3,107,50,-57
1,0,3,4,3,24,78,54
1,0,2,2,5,136,70,-66
1,0,3,0,3,81,98,17
1,0,0,0,3,213,68,-145
3,0,3,0,3,101,54,-47
3,0,0,0,3,36,17,-19
1,0,2,2,5,184,59,-125
1,0,6,1,3,7,58,51
3,0,2,3,5,7,23,16
0,1,3,4,3,6,60,54
3,0,6,0,3,37,17,-20
0,1,5,2,3,74,41,-33
3,1,0,0,3,83,270,187
1,0,6,4,3,4,12,8
1,0,0,1,3,100,183,83
3,0,2,2,5,104,94,-10
3,1,3,0,3,88,154,66
3,0,2,1,5,125,7,-118
3,0,0,4,3,36,42,6
2,0,0,0,3,49,71,22
3,0,2,7,5,4,3,-1
3,1,1,6,3,32,4,-28
1,0,0,1,3,118,53,-65
3,1,4,7,3,11,22,11
3,1,4,1,3,9,54,45
3,0,0,1,3,13,51,38
3,0,0,0,3,27,67,40
3,0,0,0,3,83,54,-29
1,0,3,4,3,56,84,28
3,0,6,0,3,241,38,-203
1,0,0,0,3,160,105,-55
1,0,3,0,3,111,196,85
1,0,3,0,3,9,86,77
3,0,4,1,3,8,157,149
3,0,0,0,3,88,52,-36
1,0,6,1,3,11,52,41
2,0,0,0,3,63,91,28
1,0,2,2,5,41,7,-34
1,0,0,1,3,111,17,-94
3,0,0,1,3,72,47,-25
3,0,0,1,3,36,63,27
3,0,6,7,3,1,8,7
3,0,6,7,3,15,3,-12
1,0,0,0,3,14,122,108
1,0,2,2,5,28,25,-3
2,0,2,3,5,65,198,133
1,0,0,0,3,130,329,199
3,0,2,0,5,151,26,-125
1,0,6,0,3,262,58,-204
1,0,3,0,3,48,242,194
1,0,5,1,3,28,77,49
2,0,2,1,5,19,91,72
1,0,1,1,3,40,135,95
3,0,2,0,5,43,217,174
3,0,5,3,3,62,7,-55
3,0,3,1,3,34,53,19
3,0,5,0,3,139,326,187
1,0,1,0,3,63,153,90
3,0,2,0,5,91,96,5
3,0,0,0,3,29,64,35
1,0,2,0,5,71,157,86
1,0,3,6,3,28,42,14
3,0,2,0,5,71,18,-53
1,0,5,0,3,38,10,-28
1,0,3,6,3,50,74,24
1,0,3,7,3,57,77,20
3,1,7,5,3,7,6,-1
2,0,2,0,5,47,1,-46
3,0,0,0,3,333,46,-287
1,0,0,0,3,125,48,-77
0,1,3,0,3,22,66,44
3,0,3,4,3,45,37,-8
3,0,2,0,5,100,16,-84
3,0,4,4,3,8,46,38
1,0,2,0,5,207,53,-154
3,1,3,0,3,33,61,28
3,0,2,0,5,24,49,25
0,1,5,4,3,8,4,-4
1,0,0,4,3,1,47,46
1,0,6,2,3,60,4,-56
3,0,2,1,5,52,144,92
3,0,2,0,5,107,133,26
1,0,0,6,3,51,105,54
2,0,2,1,5,98,31,-67
3,0,1,1,3,18,107,89
1,0,6,0,3,42,28,-14
3,0,2,1,5,120,28,-92
0,1,3,1,3,158,66,-92
3,0,3,6,3,17,74,57
0,1,5,1,3,11,38,27
1,0,0,0,3,85,48,-37
2,0,0,6,3,38,42,4
3,1,0,0,3,232,27,-205
3,0,0,7,3,7,33,26
3,0,3,0,3,11,309,298
3,0,6,2,3,6,35,29
3,0,0,4,3,38,10,-28
2,0,0,0,3,63,121,58
3,0,3,1,3,28,42,14
3,1,0,1,3,490,114,-376
1,1,0,4,3,72,115,43
1,0,0,0,3,94,97,3
3,0,0,1,3,25,56,31
1,0,5,0,3,36,86,50
1,0,6,2,3,1,23,22
3,0,5,1,3,23,38,15
1,0,0,0,3,102,38,-64
1,0,2,0,5,129,119,-10
1,0,3,1,3,214,90,-124
1,0,0,0,3,91,71,-20
3,0,2,3,5,14,8,-6
3,1,1,6,3,11,71,60
1,0,3,0,3,109,51,-58
1,0,3,6,3,51,17,-34
1,0,3,0,3,283,1360,1077
2,0,2,1,5,17,56,39
3,1,0,1,3,126,79,-47
1,1,0,4,3,140,22,-118
3,0,6,0,3,33,152,119
3,1,1,1,3,14,99,85
3,0,2,2,5,192,91,-101
1,0,2,0,5,33,70,37
3,0,4,0,3,127,104,-23
3,1,0,1,3,81,15,-66
3,0,2,1,5,113,3,-110
2,0,2,2,5,34,5,-29
3,1,6,2,3,3,14,11
3,0,4,1,3,10,124,114
1,0,0,0,3,148,126,-22
1,0,3,0,3,63,54,-9
1,0,4,0,3,165,20,-145
3,0,2,1,5,47,15,-32
3,0,3,1,3,24,221,197
3,0,2,2,5,5,27,22
3,0,0,0,3,54,53,-1
2,0,2,0,5,73,52,-21
3,0,0,0,3,44,40,-4
3,1,1,4,3,44,3,-41
2,0,2,1,5,78,3,-75
1,0,0,4,3,151,136,-15
2,0,2,0,5,79,218,139
3,0,6,0,3,50,63,13
1,0,3,5,3,35,148,113
1,0,0,4,3,79,30,-49
1,0,0,0,3,40,96,56
1,0,3,1,3,34,459,425
0,1,3,4,3,59,162,103
3,0,0,1,3,105,96,-9
0,1,3,0,3,70,21,-49
3,1,0,7,3,37,27,-10
3,1,6,4,3,34,11,-23
1,1,0,1,3,143,31,-112
0,1,3,0,3,71,120,49
3,0,6,2,3,19,15,-4
3,0,2,7,5,38,3,-35
2,0,2,1,5,84,35,-49
3,0,3,4,3,85,53,-32
3,0,2,0,5,82,33,-49
3,1,7,5,3,3,2,-1
1,0,3,0,3,99,184,85
2,0,2,0,5,40,138,98
3,0,6,0,3,40,48,8
3,0,2,0,5,33,92,59
1,0,2,0,5,48,119,71
3,0,3,5,3,107,54,-53
3,0,6,0,3,60,44,-16
3,0,2,0,5,38,62,24
3,0,0,0,3,32,58,26
1,0,0,1,3,45,60,15
3,1,0,0,3,99,53,-46
3,1,0,4,3,10,129,119
3,1,0,1,3,50,27,-23
3,0,2,0,5,36,71,35
3,0,6,0,3,107,40,-67
3,1,7,5,3,9,2,-7
3,0,5,2,3,7,29,22
1,0,0,0,3,89,59,-30
